Rk,Player,Nation,Pos,Squad,Age,Born,90s,Tkl,TklW,Def 3rd,Mid 3rd,Att 3rd,Tkl,Att,Tkl%,Past,Blocks,Sh,Pass,Int,Tkl+Int,Clr,Err,Matches,-9999
1,Patrick van Aanholt,nl NED,DF,Crystal Palace,29,1990,19.7,35,22,18,17,0,19,43,44.2,24,18,6,12,30,65,40,2,Matches,5f09991f
2,Tammy Abraham,eng ENG,FW,Chelsea,22,1997,11.6,7,5,3,3,1,1,7,14.3,6,6,0,6,5,12,17,0,Matches,f586779e
3,Che Adams,sct SCO,FW,Southampton,24,1996,29.6,25,16,4,15,6,6,17,35.3,11,20,2,18,4,29,19,1,Matches,f2bf1b0f
4,Tosin Adarabioyo,eng ENG,DF,Fulham,22,1997,32.8,37,19,30,6,1,19,40,47.5,21,26,20,6,42,79,197,2,Matches,c81d773d
5,Adrián,es ESP,GK,Liverpool,33,1987,3.0,0,0,0,0,0,0,0,,0,0,0,0,0,0,3,1,Matches,f76e6b4e
6,Sergio Agüero,ar ARG,FW,Manchester City,32,1988,6.2,4,1,0,2,2,2,11,18.2,9,2,0,2,2,6,0,0,Matches,4d034881
7,Ola Aina,ng NGA,DF,Fulham,23,1996,29.6,37,20,22,7,8,21,43,48.8,22,22,6,16,45,82,94,2,Matches,246d153b
8,Rayan Aït Nouri,fr FRA,DF,Wolves,19,2001,15.6,29,16,18,10,1,13,27,48.1,14,14,1,13,15,44,25,0,Matches,9b398aea
9,Semi Ajayi,ng NGA,DF,West Brom,26,1993,30.9,40,14,34,6,0,23,41,56.1,18,51,32,19,42,82,122,2,Matches,d6192210
10,Nathan Aké,nl NED,DF,Manchester City,25,1995,8.9,10,5,3,6,1,3,4,75.0,1,2,1,1,9,19,23,0,Matches,eaeca114
11,Marc Albrighton,eng ENG,DFFW,Leicester City,30,1989,19.4,33,19,14,15,4,16,45,35.6,29,29,3,26,17,50,27,1,Matches,b827d5b3
12,Thiago Alcántara,es ESP,MF,Liverpool,29,1991,20.6,61,36,20,30,11,17,49,34.7,32,26,0,26,30,91,14,0,Matches,77e84962
13,Toby Alderweireld,be BEL,DF,Tottenham,31,1989,24.9,35,22,22,11,2,18,30,60.0,12,40,28,12,10,45,121,0,Matches,f7d50789
14,Rúnar Alex Rúnarsson,is ISL,GK,Arsenal,25,1995,0.2,0,0,0,0,0,0,0,,0,0,0,0,0,0,0,0,Matches,8fa8f8d2
15,Trent Alexander-Arnold,eng ENG,DF,Liverpool,21,1998,33.7,56,33,31,18,7,36,56,64.3,20,24,3,21,49,105,50,3,Matches,cd1acf9d
16,Ezgjan Alioski,mk MKD,DFMF,Leeds United,28,1992,27.3,74,31,38,28,8,32,74,43.2,42,17,2,15,23,97,50,2,Matches,1a7fcf39
17,Alisson,br BRA,GK,Liverpool,27,1992,33.0,3,2,3,0,0,3,4,75.0,1,0,0,0,2,5,26,7,Matches,7a2e46a8
18,Allan,br BRA,MF,Everton,29,1991,22.8,80,45,39,37,4,28,95,29.5,67,31,12,19,19,99,25,1,Matches,cc700722
19,Dele Alli,eng ENG,MF,Tottenham,24,1996,6.9,18,11,8,6,4,7,19,36.8,12,9,0,9,7,25,3,0,Matches,cea4ee8f
20,Miguel Almirón,py PAR,MFFW,Newcastle Utd,26,1994,27.0,49,29,21,25,3,14,56,25.0,42,23,4,19,25,74,20,1,Matches,862a1c15
21,Marcos Alonso,es ESP,DF,Chelsea,29,1990,10.7,13,3,6,4,3,7,14,50.0,7,12,1,11,12,25,30,0,Matches,f4290206
22,Steven Alzate,co COL,MF,Brighton,21,1998,10.0,17,8,10,4,3,6,15,40.0,9,8,1,7,8,25,10,0,Matches,ad1f61f3
23,Daniel Amartey,gh GHA,DF,Leicester City,25,1994,8.0,11,7,6,4,1,8,12,66.7,4,8,4,4,12,23,26,0,Matches,1a4ef233
24,Ethan Ampadu,wls WAL,DFMF,Sheffield Utd,19,2000,23.2,57,36,31,24,2,20,46,43.5,26,40,19,21,49,106,87,3,Matches,10b9fa99
25,Joachim Andersen,dk DEN,DF,Fulham,24,1996,30.3,33,19,18,11,4,15,28,53.6,13,24,13,11,44,77,151,1,Matches,e34fc66d
26,Elliot Anderson,sct SCO,MF,Newcastle Utd,17,2002,0.0,0,0,0,0,0,0,0,,0,0,0,0,0,0,0,0,Matches,de31038e
27,Felipe Anderson,br BRA,FWMF,West Ham,27,1993,0.0,1,1,0,1,0,0,0,,0,0,0,0,0,1,0,0,Matches,9f1893b9
28,Michail Antonio,jm JAM,FW,West Ham,30,1990,21.9,7,4,1,5,1,1,7,14.3,6,20,3,17,7,14,7,0,Matches,ac05f970
29,Alphonse Areola,fr FRA,GK,Fulham,27,1993,36.0,1,0,1,0,0,1,5,20.0,4,0,0,0,1,2,13,3,Matches,2f965a72
30,Stuart Armstrong,sct SCO,MF,Southampton,28,1992,30.7,60,41,19,32,9,27,75,36.0,48,26,1,25,24,84,19,0,Matches,97333cf5
31,Kepa Arrizabalaga,es ESP,GK,Chelsea,25,1994,6.5,0,0,0,0,0,0,1,0.0,1,0,0,0,0,0,0,3,Matches,28d596a0
32,Pierre-Emerick Aubameyang,ga GAB,FW,Arsenal,31,1989,25.9,12,8,7,4,1,3,20,15.0,17,18,0,18,7,19,17,0,Matches,d5dd5f1f
33,Serge Aurier,ci CIV,DF,Tottenham,27,1992,17.8,55,33,33,17,5,15,40,37.5,25,28,5,23,19,74,44,3,Matches,5c2b4f07
34,Charlie Austin,eng ENG,FWMF,West Brom,31,1989,1.5,4,2,1,2,1,1,3,33.3,2,0,0,0,3,7,4,0,Matches,8d228291
35,Jordan Ayew,gh GHA,FWMF,Crystal Palace,28,1991,23.3,38,26,8,16,14,16,44,36.4,28,28,2,26,16,54,12,0,Matches,da052c14
36,Luke Ayling,eng ENG,DF,Leeds United,28,1991,37.8,108,61,69,30,9,49,87,56.3,38,53,36,17,36,144,96,5,Matches,420d7c7d
37,César Azpilicueta,es ESP,DF,Chelsea,30,1989,24.3,53,28,22,24,7,19,37,51.4,18,30,5,25,28,81,62,2,Matches,53cad200
38,Eric Bailly,ci CIV,DF,Manchester Utd,26,1994,10.2,5,5,3,1,1,0,1,0.0,1,13,11,2,13,18,36,2,Matches,a1232f4e
39,Fabián Balbuena,py PAR,DF,West Ham,28,1991,13.3,24,12,23,1,0,14,23,60.9,9,23,6,17,25,49,63,0,Matches,3626f7d9
40,George Baldock,gr GRE,DF,Sheffield Utd,27,1993,31.0,47,34,28,14,5,21,50,42.0,29,26,7,19,25,72,70,1,Matches,394854c4
41,Gareth Bale,wls WAL,FW,Tottenham,31,1989,10.2,17,10,4,9,4,7,14,50.0,7,13,2,11,8,25,16,0,Matches,a58bb1e1
42,Patrick Bamford,eng ENG,FW,Leeds United,26,1993,33.9,21,9,2,11,8,8,27,29.6,19,14,4,10,10,31,37,0,Matches,93feac6e
43,Phil Bardsley,sct SCO,DF,Burnley,35,1985,3.0,6,5,4,2,0,3,6,50.0,3,3,1,2,6,12,12,0,Matches,1ae30132
44,Ross Barkley,eng ENG,MF,Aston Villa,26,1993,17.0,6,2,2,4,0,3,15,20.0,12,9,1,8,5,11,6,1,Matches,3a24769f
45,Ross Barkley,eng ENG,FWMF,Chelsea,26,1993,0.5,0,0,0,0,0,0,0,,0,0,0,0,0,0,0,0,Matches,3a24769f
46,Ashley Barnes,eng ENG,FW,Burnley,30,1989,14.8,12,6,2,6,4,3,13,23.1,10,14,2,12,5,17,11,0,Matches,2691c772
47,Harvey Barnes,eng ENG,FWMF,Leicester City,22,1997,21.6,19,9,11,3,5,5,22,22.7,17,16,3,13,8,27,11,0,Matches,3ea50f67
48,Kyle Bartley,eng ENG,DF,West Brom,29,1991,28.7,27,16,14,10,3,11,23,47.8,12,50,35,15,38,65,159,1,Matches,18e96f64
49,Chris Basham,eng ENG,DFMF,Sheffield Utd,32,1988,28.6,69,42,41,23,5,41,67,61.2,26,36,15,21,49,118,105,1,Matches,1aa84968
50,Michy Batshuayi,be BEL,FW,Crystal Palace,26,1993,8.1,5,3,1,2,2,1,9,11.1,8,5,1,4,4,9,5,0,Matches,2973d8ff
51,Jan Bednarek,pl POL,DF,Southampton,24,1996,34.4,37,19,25,11,1,25,49,51.0,24,44,27,17,84,121,132,0,Matches,4115ce4e
52,Donny van de Beek,nl NED,MFFW,Manchester Utd,23,1997,5.8,15,10,2,11,2,7,15,46.7,8,10,1,9,6,21,7,0,Matches,50dc94ce
53,Héctor Bellerín,es ESP,DFMF,Arsenal,25,1995,23.2,29,19,14,12,3,12,41,29.3,29,26,8,18,33,62,33,0,Matches,f874dd44
54,Saïd Benrahma,dz ALG,FWMF,West Ham,24,1995,15.5,24,15,8,11,5,8,28,28.6,20,10,0,10,8,32,8,0,Matches,5a04fd92
55,Josh Benson,eng ENG,MF,Burnley,20,1999,2.9,5,1,3,0,2,1,6,16.7,5,3,0,3,3,8,2,0,Matches,bf3aeb61
56,Christian Benteke,be BEL,FW,Crystal Palace,29,1990,20.2,15,7,1,7,7,2,9,22.2,7,17,6,11,4,19,39,0,Matches,ab070c55
57,Gaetano Berardi,ch SUI,DF,Leeds United,31,1988,1.3,2,2,1,0,1,0,0,,0,2,1,1,1,3,2,0,Matches,5348aada
58,Jóhann Berg Guðmundsson,is ISL,MF,Burnley,29,1990,15.1,19,11,6,9,4,11,23,47.8,12,11,2,9,17,36,19,0,Matches,f72293fc
59,Sander Berge,no NOR,MF,Sheffield Utd,22,1998,12.4,16,7,8,5,3,7,15,46.7,8,11,2,9,4,20,18,0,Matches,d0b6129f
60,Steven Bergwijn,nl NED,FWMF,Tottenham,22,1997,13.4,15,7,8,3,4,7,20,35.0,13,7,1,6,5,20,9,0,Matches,a29b1131
61,Bernard,br BRA,MFFW,Everton,27,1992,5.1,8,3,3,3,2,7,15,46.7,8,5,0,5,8,16,6,0,Matches,ab4b3e35
62,Bernardo,br BRA,DFMF,Brighton,25,1995,2.3,10,8,8,1,1,4,6,66.7,2,2,0,2,1,11,1,0,Matches,17370b95
63,Ryan Bertrand,eng ENG,DF,Southampton,30,1989,28.9,60,32,26,27,7,30,48,62.5,18,19,1,18,30,90,41,1,Matches,01226327
64,Yves Bissouma,ml MLI,MF,Brighton,23,1996,34.6,104,68,50,48,6,33,67,49.3,34,42,6,36,64,168,67,0,Matches,6c203af0
65,Jayden Bogle,eng ENG,DFMF,Sheffield Utd,20,2000,12.3,33,23,21,10,2,20,39,51.3,19,14,4,10,14,47,22,0,Matches,ae5019e6
66,Willy Boly,ci CIV,DF,Wolves,29,1991,20.9,33,20,26,7,0,13,24,54.2,11,18,12,6,32,65,84,1,Matches,a4ac4b8f
67,Jarrod Bowen,eng ENG,FWMF,West Ham,23,1996,28.5,26,15,12,7,7,10,29,34.5,19,19,1,18,22,48,10,0,Matches,79c84d1c
68,Robbie Brady,ie IRL,MF,Burnley,28,1992,11.7,22,15,12,6,4,12,35,34.3,23,16,0,16,9,31,29,1,Matches,96bb8cc2
69,Rhian Brewster,eng ENG,FWMF,Sheffield Utd,20,2000,12.5,8,5,1,4,3,1,13,7.7,12,15,2,13,5,13,5,0,Matches,30e81a88
70,Nathan Broadhead,wls WAL,FW,Everton,22,1998,0.0,1,1,0,1,0,0,0,,0,0,0,0,0,1,0,0,Matches,43309491
71,Josh Brownhill,eng ENG,MF,Burnley,24,1995,31.3,45,27,9,29,7,15,44,34.1,29,33,11,22,69,114,39,0,Matches,47369df8
72,Joe Bryan,eng ENG,DFMF,Fulham,26,1993,7.4,15,8,7,5,3,7,12,58.3,5,8,2,6,14,29,16,0,Matches,af69e7f0
73,Kean Bryan,eng ENG,DF,Sheffield Utd,23,1996,11.2,20,10,9,11,0,9,19,47.4,10,16,10,6,13,33,39,1,Matches,c684d3c9
74,Oliver Burke,sct SCO,FW,Sheffield Utd,23,1997,14.1,16,8,6,9,1,5,24,20.8,19,24,0,24,2,18,6,0,Matches,f631c17f
75,Dan Burn,eng ENG,DF,Brighton,28,1992,22.9,50,26,33,14,3,27,53,50.9,26,30,7,23,31,81,75,0,Matches,b2d31e83
76,Jack Butland,eng ENG,GK,Crystal Palace,27,1993,1.0,0,0,0,0,0,0,0,,0,0,0,0,0,0,0,0,Matches,cc70a1d5
77,David Button,eng ENG,GK,West Brom,31,1989,1.0,0,0,0,0,0,0,0,,0,0,0,0,0,0,0,0,Matches,e608ed4c
78,Oskar Buur,dk DEN,DF,Wolves,22,1998,0.2,0,0,0,0,0,0,2,0.0,2,0,0,0,0,0,0,0,Matches,aa6f2f2c
79,Willy Caballero,ar ARG,GK,Chelsea,38,1981,1.0,0,0,0,0,0,0,0,,0,0,0,0,0,0,0,0,Matches,a179d516
80,Gary Cahill,eng ENG,DF,Crystal Palace,34,1985,20.0,13,9,10,3,0,7,11,63.6,4,27,22,5,13,26,88,0,Matches,7914b9fe
81,Tom Cairney,sct SCO,MF,Fulham,29,1991,8.4,9,3,1,4,4,1,4,25.0,3,6,0,6,0,9,3,0,Matches,a8748947
82,Dominic Calvert-Lewin,eng ENG,FW,Everton,23,1997,31.9,17,8,1,8,8,6,12,50.0,6,22,6,16,6,23,33,0,Matches,59e6e5bf
83,João Cancelo,pt POR,DFMF,Manchester City,26,1994,25.5,68,41,42,19,7,43,83,51.8,40,23,2,21,41,109,33,2,Matches,bd6351cd
84,Ian Carlo Poveda,eng ENG,MF,Leeds United,20,2000,3.9,5,4,3,0,2,1,7,14.3,6,5,1,4,1,6,2,0,Matches,55b4f1d6
85,Andy Carroll,eng ENG,FW,Newcastle Utd,31,1989,4.4,3,1,1,1,1,1,8,12.5,7,1,0,1,0,3,14,0,Matches,b581987a
86,Scott Carson,eng ENG,GK,Manchester City,34,1985,1.0,0,0,0,0,0,0,0,,0,0,0,0,0,0,0,0,Matches,3e1550ee
87,Fabio Carvalho,pt POR,MFFW,Fulham,17,2002,2.8,9,6,4,4,1,5,9,55.6,4,2,0,2,1,10,1,1,Matches,966e28d0
88,Matty Cash,pl POL,DF,Aston Villa,22,1997,26.4,71,40,43,22,6,41,74,55.4,33,50,11,39,60,131,95,0,Matches,2389cdc2
89,Kiko Casilla,es ESP,GK,Leeds United,33,1986,3.0,0,0,0,0,0,0,0,,0,0,0,0,0,0,0,0,Matches,58bc7d18
90,Timothy Castagne,be BEL,DF,Leicester City,24,1995,26.1,52,32,29,18,5,24,44,54.5,20,29,5,24,29,81,62,1,Matches,197640fd
91,Jonny Castro,es ESP,MFDF,Wolves,26,1994,5.5,11,5,6,4,1,6,13,46.2,7,9,3,6,9,20,7,0,Matches,e28868f3
92,Ivan Cavaleiro,pt POR,FW,Fulham,26,1993,27.5,23,14,9,11,3,12,34,35.3,22,25,1,24,19,42,14,0,Matches,979b811d
93,Edinson Cavani,uy URU,FW,Manchester Utd,33,1987,15.3,12,8,1,8,3,2,13,15.4,11,2,0,2,6,18,11,0,Matches,527f063d
94,Dani Ceballos,es ESP,MF,Arsenal,23,1996,17.9,37,22,20,11,6,21,51,41.2,30,23,6,17,35,72,14,1,Matches,c0617e2b
95,Calum Chambers,eng ENG,DF,Arsenal,25,1995,8.4,7,3,3,2,2,3,8,37.5,5,6,2,4,10,17,37,0,Matches,dc6f5bdd
96,Ben Chilwell,eng ENG,DF,Chelsea,23,1996,25.4,42,22,16,22,4,15,33,45.5,18,28,3,25,24,66,58,0,Matches,d2424d1b
97,Hamza Choudhury,eng ENG,MF,Leicester City,22,1997,3.5,8,7,3,5,0,4,10,40.0,6,4,1,3,4,12,9,1,Matches,7d2d3329
98,Andreas Christensen,dk DEN,DF,Chelsea,24,1996,15.2,11,6,8,3,0,0,8,0.0,8,19,14,5,20,31,51,1,Matches,1cb49278
99,Carney Chukwuemeka,eng ENG,MFFW,Aston Villa,16,2003,0.2,2,2,1,0,1,1,3,33.3,2,0,0,0,0,2,0,0,Matches,b2f9c73e
100,Ciaran Clark,ie IRL,DF,Newcastle Utd,30,1989,21.0,24,14,15,6,3,6,13,46.2,7,27,20,7,29,53,104,1,Matches,2b91cf8e
101,Nathaniel Clyne,eng ENG,DF,Crystal Palace,29,1991,12.7,17,10,8,8,1,9,16,56.3,7,7,2,5,18,35,25,1,Matches,0442183b
102,Conor Coady,eng ENG,DF,Wolves,27,1993,36.7,35,23,25,10,0,19,35,54.3,16,40,32,8,27,62,134,2,Matches,2928dca2
103,Séamus Coleman,ie IRL,DFMF,Everton,31,1988,17.9,39,26,21,14,4,21,30,70.0,9,22,6,16,13,52,37,2,Matches,0420d84f
104,Aaron Connolly,ie IRL,FW,Brighton,20,2000,8.8,6,3,1,3,2,0,2,0.0,2,4,0,4,0,6,2,0,Matches,27c01749
105,Liam Cooper,sct SCO,DF,Leeds United,28,1991,24.3,68,45,39,27,2,37,59,62.7,22,39,32,7,61,129,70,1,Matches,dc64b8b3
106,Theo Corbeanu,ca CAN,FW,Wolves,18,2002,0.1,2,1,0,2,0,1,1,100.0,0,0,0,0,1,3,0,0,Matches,25b82f9a
107,Jack Cork,eng ENG,MF,Burnley,31,1989,15.0,26,10,5,17,4,11,31,35.5,20,15,4,11,16,42,20,0,Matches,74e12f1e
108,Hélder Costa,ao ANG,MFFW,Leeds United,26,1994,12.8,25,11,12,5,8,11,32,34.4,21,11,0,11,3,28,5,1,Matches,f13d02a6
109,Vladimír Coufal,cz CZE,DF,West Ham,27,1992,33.9,73,36,50,15,8,52,89,58.4,37,41,7,34,41,114,102,1,Matches,fdf3cb77
110,Aaron Cresswell,eng ENG,DF,West Ham,30,1989,35.2,32,13,15,15,2,18,32,56.3,14,29,14,15,32,64,79,2,Matches,4f974391
111,Patrick Cutrone,it ITA,FW,Wolves,22,1998,0.3,0,0,0,0,0,0,0,,0,0,0,0,0,0,0,0,Matches,a4fe8cda
112,Stuart Dallas,nir NIR,MFDF,Leeds United,29,1991,37.9,74,45,46,22,6,30,88,34.1,58,41,3,38,44,118,52,1,Matches,67ca8566
113,Scott Dann,eng ENG,DF,Crystal Palace,33,1987,15.0,6,4,5,1,0,4,11,36.4,7,16,14,2,18,24,59,1,Matches,52105203
114,Karl Darlow,eng ENG,GK,Newcastle Utd,29,1990,25.0,0,0,0,0,0,0,0,,0,0,0,0,0,0,17,0,Matches,cde3309f
115,Ben Davies,wls WAL,DF,Tottenham,27,1993,15.0,27,17,10,11,6,13,30,43.3,17,10,5,5,18,45,49,2,Matches,44781702
116,Tom Davies,eng ENG,MF,Everton,22,1998,15.8,31,18,17,12,2,16,39,41.0,23,15,9,6,34,65,21,2,Matches,9228b07c
117,Keinan Davis,eng ENG,FWMF,Aston Villa,22,1998,3.1,2,1,1,0,1,0,1,0.0,1,1,0,1,0,2,2,0,Matches,9deaf2c8
118,Leif Davis,eng ENG,DF,Leeds United,20,2000,0.4,0,0,0,0,0,0,3,0.0,3,1,0,1,1,1,0,0,Matches,8574c61f
119,Craig Dawson,eng ENG,DF,West Ham,30,1990,21.4,11,8,7,4,0,5,12,41.7,7,26,22,4,32,43,88,3,Matches,3e9e06cb
120,Kevin De Bruyne,be BEL,MF,Manchester City,29,1991,22.2,34,21,6,18,10,13,48,27.1,35,26,1,25,9,43,10,0,Matches,e46012d4
121,Liam Delap,eng ENG,FW,Manchester City,17,2003,0.4,0,0,0,0,0,0,0,,0,0,0,0,0,0,0,0,Matches,dd897ee7
122,Fabian Delph,eng ENG,MFDF,Everton,30,1989,3.0,5,2,3,2,0,1,3,33.3,2,2,0,2,4,9,8,1,Matches,111c3236
123,Leander Dendoncker,be BEL,MFDF,Wolves,25,1995,27.8,54,29,29,22,3,31,60,51.7,29,38,15,23,27,81,52,2,Matches,5a7301ae
124,Mbaye Diagne,sn SEN,FW,West Brom,28,1991,13.2,4,3,3,0,1,1,4,25.0,3,2,1,1,1,5,16,0,Matches,dda3969e
125,Amad Diallo,ci CIV,FW,Manchester Utd,18,2002,1.8,3,3,1,2,0,0,0,,0,2,1,1,0,3,1,0,Matches,9dc96f10
126,Ibrahima Diallo,fr FRA,MF,Southampton,21,1999,11.3,29,16,11,17,1,9,16,56.3,7,10,1,9,10,39,12,2,Matches,11ff3d56
127,Grady Diangana,eng ENG,MFFW,West Brom,22,1998,13.7,35,19,19,9,7,19,43,44.2,24,16,2,14,16,51,9,0,Matches,f522d7ec
128,Rúben Dias,pt POR,DF,Manchester City,23,1997,31.6,24,13,13,8,3,4,16,25.0,12,31,23,8,35,59,92,0,Matches,31c69ef1
129,Eric Dier,eng ENG,DF,Tottenham,26,1994,28.0,23,14,13,10,0,11,18,61.1,7,37,31,6,23,46,123,3,Matches,ac861941
130,Lucas Digne,fr FRA,DFMF,Everton,27,1993,29.8,63,38,40,16,7,29,54,53.7,25,42,4,38,31,94,87,0,Matches,1b84dbe1
131,Issa Diop,fr FRA,DF,West Ham,23,1997,15.3,20,14,12,8,0,7,18,38.9,11,32,22,10,22,42,59,0,Matches,a712ca2b
132,Moussa Djenepo,ml MLI,MF,Southampton,22,1998,13.8,52,27,27,17,8,28,63,44.4,35,24,2,22,10,62,14,0,Matches,254147d4
133,Matt Doherty,ie IRL,DF,Tottenham,28,1992,13.8,29,15,15,10,4,13,33,39.4,20,20,5,15,23,52,46,0,Matches,d557d734
134,Gabriel Dos Santos,br BRA,DF,Arsenal,22,1997,22.2,25,15,19,5,1,13,19,68.4,6,27,19,8,26,51,74,2,Matches,67ac5bb8
135,Abdoulaye Doucouré,ml MLI,MF,Everton,27,1993,27.1,52,32,25,19,8,14,43,32.6,29,24,7,17,39,91,31,1,Matches,02b29014
136,Martin Dúbravka,sk SVK,GK,Newcastle Utd,31,1989,13.0,0,0,0,0,0,0,0,,0,0,0,0,0,0,3,0,Matches,3a949a25
137,Paul Dummett,wls WAL,DF,Newcastle Utd,28,1991,13.9,16,7,11,5,0,13,21,61.9,8,12,7,5,16,32,74,0,Matches,3fe6bd8c
138,Lewis Dunk,eng ENG,DF,Brighton,28,1991,32.6,30,15,20,8,2,16,23,69.6,7,29,20,9,32,62,106,0,Matches,282f75f3
139,Jimmy Dunne,ie IRL,DF,Burnley,22,1997,3.0,3,3,2,1,0,1,2,50.0,1,3,2,1,6,9,16,1,Matches,1fdfd6da
140,Ederson,br BRA,GK,Manchester City,26,1993,36.0,3,1,3,0,0,3,4,75.0,1,0,0,0,0,3,11,4,Matches,3bb7b8b4
141,Kyle Edwards,eng ENG,MFFW,West Brom,22,1998,1.3,3,2,1,1,1,0,0,,0,2,0,2,1,4,0,0,Matches,1566e437
142,John Egan,ie IRL,DF,Sheffield Utd,27,1992,29.2,41,21,29,12,0,22,39,56.4,17,43,31,12,41,82,131,0,Matches,debe38a0
143,Anthony Elanga,se SWE,FW,Manchester Utd,18,2002,1.7,4,2,3,1,0,4,5,80.0,1,1,1,0,1,5,1,0,Matches,2fba6108
144,Ahmed Elmohamady,eg EGY,DF,Aston Villa,32,1987,9.3,17,13,12,4,1,9,14,64.3,5,6,3,3,17,34,26,0,Matches,615ef733
145,Mohamed Elneny,eg EGY,MF,Arsenal,28,1992,17.2,14,6,7,7,0,7,28,25.0,21,11,4,7,24,38,20,2,Matches,47a34c4f
146,Jonny Evans,nir NIR,DF,Leicester City,32,1988,27.5,25,12,22,2,1,14,20,70.0,6,8,3,5,46,71,98,1,Matches,f8fcd2a5
147,Eberechi Eze,eng ENG,MF,Crystal Palace,22,1998,28.4,27,14,11,13,3,16,35,45.7,19,19,3,16,24,51,9,1,Matches,ae4fc6a4
148,Łukasz Fabiański,pl POL,GK,West Ham,35,1985,35.0,1,0,1,0,0,1,1,100.0,0,1,0,1,1,2,12,3,Matches,9328b835
149,Fabinho,br BRA,DFMF,Liverpool,26,1993,28.5,58,31,21,29,8,27,54,50.0,27,28,10,18,44,102,66,1,Matches,7f3b388c
150,Bruno Fernandes,pt POR,MF,Manchester Utd,25,1994,34.4,57,30,16,29,12,26,100,26.0,74,38,0,38,26,83,29,0,Matches,507c7bdf
151,Federico Fernández,ar ARG,DF,Newcastle Utd,31,1989,23.1,29,22,23,5,1,17,21,81.0,4,41,31,10,17,46,147,0,Matches,f25b010f
152,Fernandinho,br BRA,MF,Manchester City,35,1985,13.2,31,17,8,14,9,20,43,46.5,23,11,2,9,23,54,17,0,Matches,101da2b5
153,Sam Field,eng ENG,MF,West Brom,22,1998,0.7,5,5,3,2,0,0,0,,0,4,1,3,2,7,4,0,Matches,bd8a7d05
154,Roberto Firmino,br BRA,FW,Liverpool,28,1991,31.5,33,15,3,17,13,6,32,18.8,26,42,5,37,11,44,12,0,Matches,4c370d81
155,John Fleck,sct SCO,MF,Sheffield Utd,28,1991,28.6,51,33,28,18,5,26,83,31.3,57,26,4,22,28,79,12,1,Matches,b63e789d
156,Phil Foden,eng ENG,FWMF,Manchester City,20,2000,18.0,22,11,12,8,2,9,23,39.1,14,9,0,9,11,33,11,0,Matches,ed1e53f3
157,Wesley Fofana,fr FRA,DF,Leicester City,19,2000,25.1,51,37,27,22,2,31,46,67.4,15,28,16,12,61,112,94,0,Matches,132a82f1
158,Pablo Fornals,es ESP,FWMF,West Ham,24,1996,28.6,44,26,14,24,6,11,73,15.1,62,43,1,42,36,80,9,0,Matches,82927de4
159,Fraser Forster,eng ENG,GK,Southampton,32,1988,8.0,1,0,1,0,0,1,2,50.0,1,0,0,0,0,1,9,0,Matches,c3e39f12
160,Timothy Fosu-Mensah,nl NED,DF,Manchester Utd,22,1998,0.9,2,0,1,1,0,1,1,100.0,0,0,0,0,3,5,1,0,Matches,a9142dc3
161,Tyrese Francois,au AUS,DF,Fulham,20,2000,0.2,0,0,0,0,0,0,0,,0,0,0,0,0,0,0,0,Matches,6722d4f0
162,Ryan Fraser,sct SCO,FWMF,Newcastle Utd,26,1994,10.3,4,1,3,1,0,2,5,40.0,3,1,0,1,6,10,7,0,Matches,d56543a0
163,Fred,br BRA,MF,Manchester Utd,27,1993,26.6,81,39,39,38,4,29,89,32.6,60,49,9,40,45,126,26,1,Matches,b853e0ad
164,Ryan Fredericks,eng ENG,DFFW,West Ham,27,1992,6.3,9,5,5,4,0,3,7,42.9,4,6,2,4,11,20,20,0,Matches,c067631c
165,Christian Fuchs,at AUT,DF,Leicester City,34,1986,7.8,18,7,15,2,1,8,15,53.3,7,6,4,2,16,34,34,1,Matches,a67a09fb
166,Darnell Furlong,eng ENG,DF,West Brom,24,1995,32.6,45,27,27,12,6,21,44,47.7,23,39,16,23,49,94,90,0,Matches,3ec9195b
167,Conor Gallagher,eng ENG,MF,West Brom,20,2000,28.1,81,41,30,39,12,29,97,29.9,68,47,8,39,27,108,31,0,Matches,c2731c10
168,Eric García,es ESP,DF,Manchester City,19,2001,4.3,8,7,5,3,0,5,7,71.4,2,4,1,3,4,12,10,0,Matches,2bed3eab
169,Dwight Gayle,eng ENG,FWMF,Newcastle Utd,29,1990,5.7,2,0,1,1,0,0,7,0.0,7,3,1,2,1,3,2,0,Matches,e58a03c6
170,Jean-Philippe Gbamin,ci CIV,MF,Everton,24,1995,0.1,1,0,0,1,0,0,0,,0,1,0,1,0,1,1,0,Matches,6bd603db
171,David de Gea,es ESP,GK,Manchester Utd,29,1990,25.5,0,0,0,0,0,0,0,,0,0,0,0,0,0,8,3,Matches,7ba6d84e
172,Anwar El Ghazi,nl NED,FW,Aston Villa,25,1995,17.9,16,13,6,7,3,7,23,30.4,16,11,0,11,6,22,11,0,Matches,ffa90327
173,Kieran Gibbs,eng ENG,DF,West Brom,30,1989,9.0,15,11,11,3,1,8,10,80.0,2,8,6,2,16,31,30,1,Matches,46ee5234
174,Morgan Gibbs-White,eng ENG,MFFW,Wolves,20,2000,4.6,9,7,3,4,2,5,12,41.7,7,6,0,6,3,12,1,0,Matches,32f60ed8
175,Billy Gilmour,sct SCO,MF,Chelsea,19,2001,2.9,4,2,1,2,1,2,7,28.6,5,3,2,1,3,7,1,0,Matches,df10e27c
176,Olivier Giroud,fr FRA,FW,Chelsea,33,1986,8.3,4,2,0,1,3,1,7,14.3,6,4,1,3,5,9,10,0,Matches,16ceb862
177,Ben Godfrey,eng ENG,DF,Everton,22,1998,29.8,55,33,37,15,3,27,41,65.9,14,56,37,19,33,88,120,0,Matches,9f7c837d
178,André Gomes,pt POR,MF,Everton,27,1993,17.4,35,23,16,16,3,17,58,29.3,41,19,1,18,10,45,12,1,Matches,1961b2aa
179,Joe Gomez,eng ENG,DF,Liverpool,23,1997,6.6,3,2,1,1,1,0,4,0.0,4,3,2,1,4,7,29,0,Matches,7a11550b
180,Anthony Gordon,eng ENG,FWMF,Everton,19,2001,1.0,3,3,3,0,0,0,2,0.0,2,1,0,1,1,4,3,0,Matches,2bd83368
181,Karlan Grant,eng ENG,FWMF,West Brom,22,1997,12.5,5,3,3,2,0,2,4,50.0,2,7,0,7,5,10,17,0,Matches,87f7500e
182,Demarai Gray,eng ENG,FW,Leicester City,24,1996,0.2,1,1,1,0,0,0,0,,0,0,0,0,0,1,0,0,Matches,4468ec10
183,Jack Grealish,eng ENG,FWMF,Aston Villa,24,1995,24.3,31,14,8,16,7,15,24,62.5,9,20,3,17,12,43,5,3,Matches,b0b4fd3e
184,Mason Greenwood,eng ENG,FW,Manchester Utd,18,2001,20.2,13,10,6,4,3,5,22,22.7,17,9,0,9,5,18,1,0,Matches,58eee997
185,Pascal Groß,de GER,MFDF,Brighton,29,1991,27.6,45,24,24,15,6,24,53,45.3,29,25,4,21,23,68,18,1,Matches,8aec0537
186,Kamil Grosicki,pl POL,MFFW,West Brom,32,1988,1.6,2,1,2,0,0,2,8,25.0,6,1,0,1,2,4,1,0,Matches,81d8091f
187,Vicente Guaita,es ESP,GK,Crystal Palace,33,1987,37.0,1,1,1,0,0,1,1,100.0,0,0,0,0,1,2,11,1,Matches,ab13a5aa
188,İlkay Gündoğan,de GER,MF,Manchester City,29,1990,22.5,25,15,8,12,5,10,39,25.6,29,13,4,9,20,45,9,0,Matches,819b3158
189,Antwoine Hackford,eng ENG,DF,Sheffield Utd,16,2004,0.1,0,0,0,0,0,0,0,,0,0,0,0,0,0,0,0,Matches,a7588cdc
190,Sébastien Haller,ci CIV,FW,West Ham,26,1994,10.4,14,9,1,6,7,4,20,20.0,16,7,1,6,5,19,7,0,Matches,ba115a40
191,Rekeem Harper,eng ENG,MF,West Brom,20,2000,0.4,0,0,0,0,0,0,0,,0,2,0,2,1,1,0,0,Matches,3c066877
192,Jack Harrison,eng ENG,MFFW,Leeds United,23,1996,31.6,63,38,20,30,13,26,59,44.1,33,30,2,28,15,78,21,0,Matches,aa849a12
193,Kortney Hause,eng ENG,DF,Aston Villa,25,1995,7.0,4,2,3,1,0,0,3,0.0,3,4,2,2,8,12,53,0,Matches,bf8fad51
194,Kai Havertz,de GER,MFFW,Chelsea,21,1999,16.9,18,9,6,10,2,6,27,22.2,21,25,0,25,4,22,22,1,Matches,fed7cb61
195,Isaac Hayden,eng ENG,MFDF,Newcastle Utd,25,1995,21.6,52,29,23,22,7,14,35,40.0,21,32,9,23,43,95,47,0,Matches,c951a6df
196,Michael Hector,jm JAM,DF,Fulham,28,1992,2.9,3,2,1,2,0,1,6,16.7,5,4,2,2,0,3,6,0,Matches,5f1a2f31
197,Ahmed Hegazi,eg EGY,DF,West Brom,29,1991,1.0,0,0,0,0,0,0,0,,0,2,0,2,1,1,7,0,Matches,5540c9dc
198,Dean Henderson,eng ENG,GK,Manchester Utd,23,1997,12.5,1,1,1,0,0,1,2,50.0,1,0,0,0,0,1,3,2,Matches,e5a76dfe
199,Jordan Henderson,eng ENG,MFDF,Liverpool,30,1990,18.9,24,15,12,9,3,10,26,38.5,16,12,1,11,34,58,30,0,Matches,935e6b8f
200,Jeff Hendrick,ie IRL,MF,Newcastle Utd,28,1992,15.8,8,3,5,3,0,1,13,7.7,12,14,9,5,19,27,18,0,Matches,989d5705
201,Pablo Hernández,es ESP,MF,Leeds United,35,1985,4.7,5,3,2,1,2,5,16,31.3,11,2,0,2,0,5,0,1,Matches,c0398aca
202,Son Heung-min,kr KOR,FW,Tottenham,28,1992,34.6,32,18,11,14,7,18,72,25.0,54,28,3,25,14,46,8,0,Matches,92e7e919
203,Ki-Jana Hoever,nl NED,DFMF,Wolves,18,2002,6.4,14,6,11,2,1,10,22,45.5,12,2,0,2,9,23,23,0,Matches,9a71e978
204,Rob Holding,eng ENG,DF,Arsenal,24,1995,28.4,43,20,28,13,2,17,35,48.6,18,37,27,10,24,67,120,0,Matches,d79a8c87
205,Mason Holgate,eng ENG,DF,Everton,23,1996,25.4,56,36,31,18,7,20,50,40.0,30,37,13,24,35,91,90,3,Matches,d0042ab9
206,Conor Hourihane,ie IRL,MF,Aston Villa,29,1991,2.5,0,0,0,0,0,0,2,0.0,2,3,0,3,0,0,2,0,Matches,fcab00a0
207,Callum Hudson-Odoi,eng ENG,FWDF,Chelsea,19,2000,11.8,23,15,11,7,5,8,21,38.1,13,15,1,14,6,29,6,0,Matches,15f3ec41
208,Niall Huggins,wls WAL,DF,Leeds United,19,2000,0.4,0,0,0,0,0,0,1,0.0,1,0,0,0,0,0,1,0,Matches,6d646ff7
209,Pierre Højbjerg,dk DEN,MF,Tottenham,24,1995,38.0,98,51,45,42,11,54,129,41.9,75,51,9,42,48,146,66,0,Matches,8b04d6c1
210,Odion Ighalo,ng NGA,FW,Manchester Utd,31,1989,0.1,0,0,0,0,0,0,1,0.0,1,0,0,0,0,0,0,0,Matches,03622183
211,Kelechi Iheanacho,ng NGA,FW,Leicester City,23,1996,16.2,12,5,2,4,6,4,17,23.5,13,14,0,14,2,14,1,1,Matches,c92e1a31
212,Danny Ings,eng ENG,FW,Southampton,28,1992,24.1,22,13,3,16,3,12,28,42.9,16,39,2,37,3,25,27,1,Matches,07802f7f
213,Branislav Ivanović,rs SRB,DF,West Brom,36,1984,8.5,14,5,11,3,0,7,13,53.8,6,11,5,6,8,22,25,0,Matches,85f8571a
214,Alex Iwobi,ng NGA,FWMF,Everton,24,1996,17.1,27,10,10,14,3,13,25,52.0,12,20,1,19,16,43,14,0,Matches,6ca5ec4b
215,José Izquierdo,co COL,DF,Brighton,28,1992,0.1,0,0,0,0,0,0,0,,0,0,0,0,0,0,0,0,Matches,ca2bc3df
216,Phil Jagielka,eng ENG,DF,Sheffield Utd,37,1982,5.8,5,4,4,0,1,2,7,28.6,5,11,5,6,10,15,26,2,Matches,3233eefd
217,Alireza Jahanbakhsh,ir IRN,FWMF,Brighton,26,1993,5.9,9,7,3,5,1,2,12,16.7,10,8,0,8,8,17,1,0,Matches,08452314
218,Daniel James,wls WAL,FW,Manchester Utd,22,1997,10.1,15,9,4,7,4,3,18,16.7,15,10,1,9,0,15,6,0,Matches,c931d9f9
219,Reece James,eng ENG,DF,Chelsea,20,1999,26.4,55,35,24,22,9,21,44,47.7,23,36,7,29,17,72,52,0,Matches,1265a93a
220,Alexandre Jankewitz,ch SUI,MF,Southampton,18,2001,0.0,2,1,2,0,0,1,1,100.0,0,0,0,0,0,2,0,0,Matches,7c39363f
221,Daniel Jebbison,eng ENG,FW,Sheffield Utd,17,2003,3.2,6,2,1,3,2,3,7,42.9,4,6,1,5,1,7,0,0,Matches,03edb878
222,Gabriel Jesus,br BRA,FW,Manchester City,23,1997,22.9,17,6,5,5,7,11,28,39.3,17,16,0,16,15,32,5,0,Matches,b66315ae
223,Raúl Jiménez,mx MEX,FW,Wolves,29,1991,9.1,3,2,1,2,0,0,7,0.0,7,2,0,2,8,11,12,0,Matches,b561db50
224,Joelinton,br BRA,FWMF,Newcastle Utd,23,1996,22.0,33,21,7,21,5,14,37,37.8,23,30,2,28,9,42,24,0,Matches,c17bfb65
225,Ben Johnson,eng ENG,DFFW,West Ham,20,2000,5.8,11,5,5,3,3,7,9,77.8,2,5,1,4,11,22,9,0,Matches,9319781b
226,Sam Johnstone,eng ENG,GK,West Brom,27,1993,37.0,0,0,0,0,0,0,0,,0,0,0,0,2,2,15,2,Matches,9e5708be
227,Curtis Jones,eng ENG,MF,Liverpool,19,2001,13.1,16,6,6,7,3,12,25,48.0,13,13,0,13,19,35,11,1,Matches,4fb9c88f
228,Jorginho,it ITA,MF,Chelsea,28,1991,22.3,57,30,22,31,4,31,76,40.8,45,33,5,28,40,97,21,3,Matches,45db685d
229,Willian José,br BRA,FW,Wolves,28,1991,12.3,2,1,1,1,0,1,4,25.0,3,6,1,5,1,3,12,0,Matches,d87e2cae
230,Diogo Jota,pt POR,FW,Liverpool,23,1996,12.4,12,6,4,7,1,2,29,6.9,27,9,0,9,5,17,3,0,Matches,178ae8f8
231,James Justin,eng ENG,DF,Leicester City,22,1998,23.0,61,37,38,18,5,20,41,48.8,21,36,10,26,30,91,58,1,Matches,fb614c44
232,Ozan Kabak,tr TUR,DF,Liverpool,20,2000,8.9,19,10,11,4,4,6,9,66.7,3,2,2,0,12,31,28,1,Matches,2d61d13a
233,Aboubakar Kamara,mr MTN,FWMF,Fulham,25,1995,3.5,2,2,1,1,0,0,5,0.0,5,6,0,6,1,3,0,0,Matches,4047c976
234,Harry Kane,eng ENG,FW,Tottenham,27,1993,34.2,22,12,1,17,4,8,26,30.8,18,28,11,17,11,33,40,0,Matches,21a66f6a
235,N'Golo Kanté,fr FRA,MF,Chelsea,29,1991,23.8,79,42,39,35,5,27,56,48.2,29,42,4,38,59,138,34,0,Matches,b9fbae28
236,Moise Kean,it ITA,FWMF,Everton,20,2000,0.2,0,0,0,0,0,0,0,,0,0,0,0,0,0,0,0,Matches,3d50bcdb
237,Michael Keane,eng ENG,DF,Everton,27,1993,33.2,28,15,20,8,0,14,31,45.2,17,46,33,13,51,79,161,0,Matches,c5b7c315
238,Neeskens Kebano,cd COD,FWMF,Fulham,28,1992,1.3,0,0,0,0,0,0,1,0.0,1,3,0,3,0,0,0,0,Matches,18b999f4
239,Naby Keïta,gn GUI,MF,Liverpool,25,1995,5.8,11,5,1,8,2,7,17,41.2,10,10,0,10,9,20,6,0,Matches,f25c8e3a
240,Caoimhín Kelleher,ie IRL,GK,Liverpool,21,1998,2.0,0,0,0,0,0,0,0,,0,0,0,0,0,0,2,0,Matches,62d7ef38
241,Martin Kelly,eng ENG,DF,Crystal Palace,30,1990,0.0,1,0,1,0,0,1,1,100.0,0,0,0,0,0,1,0,0,Matches,d7492450
242,Jonjoe Kenny,eng ENG,DF,Everton,23,1997,0.9,2,1,1,0,1,2,2,100.0,0,0,0,0,1,3,3,0,Matches,099e666f
243,Reda Khadra,de GER,MF,Brighton,19,2001,0.1,0,0,0,0,0,0,0,,0,0,0,0,0,0,0,0,Matches,88acf83f
244,Max Kilman,eng ENG,DF,Wolves,23,1997,14.6,21,14,13,4,4,8,14,57.1,6,17,8,9,19,40,46,0,Matches,d0f72bf1
245,Joshua King,no NOR,MFFW,Everton,28,1992,1.6,4,1,2,1,1,0,0,,0,3,0,3,1,5,1,0,Matches,43458538
246,Mateusz Klich,pl POL,MF,Leeds United,30,1990,26.6,38,20,14,20,4,14,61,23.0,47,13,4,9,11,49,16,0,Matches,282679b4
247,Robin Koch,de GER,DFMF,Leeds United,24,1996,12.6,27,16,17,10,0,10,19,52.6,9,18,12,6,27,54,34,2,Matches,ea6bc03a
248,Sead Kolašinac,ba BIH,DF,Arsenal,27,1993,1.0,0,0,0,0,0,0,0,,0,0,0,0,1,1,0,0,Matches,3935e52e
249,Terence Kongolo,nl NED,DF,Fulham,26,1994,1.0,3,2,1,2,0,1,1,100.0,0,0,0,0,2,5,3,0,Matches,1f9a3a04
250,Ezri Konsa,eng ENG,DF,Aston Villa,22,1997,35.5,25,13,18,6,1,9,13,69.2,4,53,47,6,29,54,162,1,Matches,0313a347
251,Cheikhou Kouyaté,sn SEN,DF,Crystal Palace,30,1989,34.7,58,37,44,12,2,25,43,58.1,18,42,26,16,32,90,125,2,Matches,8d3c902d
252,Mateo Kovačić,hr CRO,MF,Chelsea,26,1994,20.2,46,28,19,24,3,17,32,53.1,15,18,1,17,15,61,11,2,Matches,79c0821a
253,Emil Krafth,se SWE,DF,Newcastle Utd,25,1994,14.3,19,8,9,9,1,12,25,48.0,13,15,9,6,15,34,52,2,Matches,77cf6852
254,Filip Krovinović,hr CRO,MF,West Brom,24,1995,6.1,13,10,6,5,2,6,18,33.3,12,2,0,2,4,17,2,0,Matches,c2dfedeb
255,Alexandre Lacazette,fr FRA,FW,Arsenal,29,1991,21.4,18,10,4,11,3,4,22,18.2,18,20,1,19,12,30,13,0,Matches,9dbb75ca
256,Adam Lallana,eng ENG,MFFW,Brighton,32,1988,17.7,28,13,11,13,4,8,39,20.5,31,18,3,15,15,43,13,0,Matches,99813635
257,Érik Lamela,ar ARG,FWMF,Tottenham,28,1992,8.0,17,9,1,11,5,8,21,38.1,13,11,1,10,6,23,2,0,Matches,abe66106
258,Tariq Lamptey,gh GHA,DFMF,Brighton,19,2000,9.8,17,9,7,6,4,6,13,46.2,7,8,1,7,19,36,12,1,Matches,f4e433d4
259,Manuel Lanzini,ar ARG,MFFW,West Ham,27,1993,6.3,9,2,3,4,2,3,10,30.0,7,9,0,9,7,16,5,0,Matches,26f6dca8
260,Aymeric Laporte,es ESP,DF,Manchester City,26,1994,14.9,13,6,10,3,0,7,11,63.6,4,12,7,5,11,24,28,0,Matches,119b9a8e
261,Jamaal Lascelles,eng ENG,DF,Newcastle Utd,26,1993,18.1,14,7,5,9,0,3,6,50.0,3,27,17,10,12,26,86,0,Matches,450ab6fc
262,Maxime Le Marchand,fr FRA,DF,Fulham,30,1989,1.4,2,2,2,0,0,2,2,100.0,0,0,0,0,0,2,3,0,Matches,321a71a7
263,Mario Lemina,ga GAB,MF,Fulham,26,1993,18.9,62,35,25,30,7,23,44,52.3,21,26,5,21,30,92,21,0,Matches,2b471f99
264,Bernd Leno,de GER,GK,Arsenal,28,1992,34.8,1,0,1,0,0,1,1,100.0,0,1,0,1,0,1,11,2,Matches,2628fd2b
265,Khanya Leshabela,za RSA,MF,Leicester City,20,1999,0.1,0,0,0,0,0,0,0,,0,0,0,0,0,0,0,0,Matches,383e68b1
266,Jamal Lewis,nir NIR,DF,Newcastle Utd,22,1998,20.4,37,20,23,13,1,16,38,42.1,22,21,7,14,11,48,44,1,Matches,efb9215a
267,Victor Lindelöf,se SWE,DF,Manchester Utd,26,1994,28.7,22,10,12,10,0,12,24,50.0,12,22,14,8,30,52,95,1,Matches,f5deef4c
268,Jesse Lingard,eng ENG,MFFW,West Ham,27,1992,15.8,12,6,4,8,0,5,14,35.7,9,7,1,6,4,16,0,0,Matches,810e3c74
269,Jake Livermore,eng ENG,MF,West Brom,30,1989,13.8,33,18,14,16,3,14,31,45.2,17,21,6,15,16,49,26,0,Matches,b98570d1
270,Diego Llorente,es ESP,DF,Leeds United,26,1993,13.4,34,21,21,13,0,19,32,59.4,13,18,13,5,20,54,40,2,Matches,bba30585
271,Hugo Lloris,fr FRA,GK,Tottenham,33,1986,38.0,0,0,0,0,0,0,1,0.0,1,0,0,0,0,0,10,1,Matches,8f62b6ee
272,Giovani Lo Celso,ar ARG,MF,Tottenham,24,1996,10.5,28,22,12,11,5,10,29,34.5,19,12,1,11,7,35,5,0,Matches,d7553721
273,Ruben Loftus-Cheek,eng ENG,FW,Chelsea,24,1996,0.7,0,0,0,0,0,0,0,,0,0,0,0,0,0,0,0,Matches,e97fd090
274,Ruben Loftus-Cheek,eng ENG,MFFW,Fulham,24,1996,21.2,25,14,7,15,3,7,23,30.4,16,20,2,18,7,32,18,0,Matches,e97fd090
275,Kevin Long,ie IRL,DF,Burnley,29,1990,7.1,11,6,9,2,0,7,9,77.8,2,11,7,4,6,17,24,0,Matches,5a4280b1
276,Shane Long,ie IRL,FW,Southampton,33,1987,2.3,2,1,0,0,2,2,3,66.7,1,0,0,0,3,5,1,0,Matches,9f472354
277,Matthew Longstaff,eng ENG,MF,Newcastle Utd,20,2000,4.2,3,2,2,1,0,2,8,25.0,6,7,0,7,7,10,2,0,Matches,c0027d2d
278,Sean Longstaff,eng ENG,MF,Newcastle Utd,22,1997,15.7,31,14,13,15,3,18,42,42.9,24,26,5,21,19,50,14,2,Matches,a2b105e0
279,Ademola Lookman,ng NGA,FWMF,Fulham,22,1997,30.5,35,11,18,9,8,13,44,29.5,31,31,1,30,20,55,9,0,Matches,7c104bb7
280,Max Lowe,eng ENG,DF,Sheffield Utd,23,1997,6.1,26,11,18,6,2,9,21,42.9,12,12,4,8,5,31,11,0,Matches,7af88b33
281,Matthew Lowton,eng ENG,DF,Burnley,31,1989,34.0,54,32,31,22,1,32,73,43.8,41,36,13,23,56,110,91,1,Matches,9a9c05db
282,David Luiz,br BRA,DF,Arsenal,33,1987,15.5,12,9,5,7,0,4,4,100.0,0,16,9,7,16,28,50,2,Matches,c0e27d1a
283,Douglas Luiz,br BRA,MF,Aston Villa,22,1998,30.9,49,18,22,26,1,20,58,34.5,38,52,17,35,43,92,44,2,Matches,6f7d826d
284,John Lundstram,eng ENG,MF,Sheffield Utd,26,1994,22.6,25,16,12,11,2,13,47,27.7,34,26,8,18,14,39,29,1,Matches,0df2b165
285,Alexis Mac Allister,ar ARG,MFFW,Brighton,21,1998,12.4,26,12,6,16,4,11,38,28.9,27,25,4,21,9,35,4,0,Matches,83d074ff
286,James Maddison,eng ENG,MF,Leicester City,23,1996,23.3,32,16,5,16,11,14,41,34.1,27,14,1,13,9,41,5,0,Matches,ee38d9c5
287,Harry Maguire,eng ENG,DF,Manchester Utd,27,1993,33.9,29,17,19,10,0,18,29,62.1,11,28,23,5,60,89,122,4,Matches,d8931174
288,Riyad Mahrez,dz ALG,FW,Manchester City,29,1991,21.7,20,5,2,10,8,6,30,20.0,24,19,0,19,8,28,4,0,Matches,892d5bb1
289,Ainsley Maitland-Niles,eng ENG,MFDF,Arsenal,22,1997,5.4,11,7,6,5,0,8,12,66.7,4,12,2,10,14,25,7,1,Matches,e3a5814e
290,Ainsley Maitland-Niles,eng ENG,MF,West Brom,22,1997,13.7,22,10,7,8,7,9,28,32.1,19,12,1,11,17,39,24,0,Matches,e3a5814e
291,Josh Maja,ng NGA,FW,Fulham,21,1998,9.0,7,4,0,3,4,4,10,40.0,6,3,1,2,4,11,1,0,Matches,bc0bfc64
292,Sadio Mané,sn SEN,FW,Liverpool,28,1992,31.2,48,30,6,22,20,12,33,36.4,21,30,0,30,15,63,11,0,Matches,c691bfe2
293,Javier Manquillo,es ESP,DF,Newcastle Utd,26,1994,9.2,24,14,8,14,2,11,17,64.7,6,8,1,7,9,33,15,1,Matches,758dd7f0
294,Fernando Marçal,br BRA,DFMF,Wolves,31,1989,6.9,13,5,6,7,0,6,11,54.5,5,11,2,9,12,25,25,0,Matches,9ae9eaea
295,Solly March,eng ENG,DFMF,Brighton,26,1994,18.6,49,23,24,15,10,18,34,52.9,16,30,5,25,22,71,30,0,Matches,bb5fbd2b
296,Pablo Marí,es ESP,DF,Arsenal,26,1993,10.0,15,9,12,3,0,5,10,50.0,5,8,7,1,9,24,30,2,Matches,aa54ec6f
297,Anthony Martial,fr FRA,FW,Manchester Utd,24,1995,16.4,2,1,1,1,0,0,10,0.0,10,17,3,14,1,3,8,0,Matches,8b788c01
298,Martinelli,br BRA,FW,Arsenal,19,2001,6.5,7,1,2,3,2,4,10,40.0,6,6,0,6,8,15,4,0,Matches,48a5a5d6
299,Emiliano Martínez,ar ARG,GK,Aston Villa,27,1992,38.0,3,3,3,0,0,3,4,75.0,1,0,0,0,2,5,10,2,Matches,7956236f
300,Arthur Masuaku,cd COD,DFMF,West Ham,26,1993,11.2,20,12,14,6,0,11,34,32.4,23,12,0,12,8,28,28,2,Matches,57df7a11
301,Juan Mata,es ESP,FWMF,Manchester Utd,32,1988,5.7,1,0,1,0,0,0,7,0.0,7,3,0,3,3,4,3,0,Matches,29733c72
302,Jean-Philippe Mateta,fr FRA,FW,Crystal Palace,23,1997,2.5,1,1,0,1,0,1,3,33.3,2,1,0,1,0,1,2,0,Matches,50e6dc35
303,Nemanja Matić,rs SRB,MF,Manchester Utd,31,1988,12.3,25,11,13,12,0,13,31,41.9,18,19,5,14,22,47,10,3,Matches,eb7822d7
304,Joël Matip,cm CMR,DF,Liverpool,28,1991,7.7,14,9,7,7,0,7,8,87.5,1,6,0,6,7,21,22,0,Matches,b217ef29
305,Neal Maupay,fr FRA,FWMF,Brighton,23,1996,27.9,20,8,9,7,4,4,24,16.7,20,20,0,20,13,33,6,0,Matches,4bcf39f6
306,James McArthur,sct SCO,MF,Crystal Palace,32,1987,16.3,57,32,25,27,5,15,39,38.5,24,28,3,25,23,80,31,0,Matches,cee31595
307,Oliver McBurnie,sct SCO,FW,Sheffield Utd,24,1996,14.7,15,7,7,7,1,5,17,29.4,12,10,3,7,6,21,30,0,Matches,78b8ac63
308,Alex McCarthy,eng ENG,GK,Southampton,30,1989,30.0,1,0,1,0,0,1,4,25.0,3,0,0,0,0,1,11,1,Matches,36c2ca73
309,James McCarthy,ie IRL,MF,Crystal Palace,29,1990,9.1,16,12,9,7,0,8,21,38.1,13,15,7,8,8,24,12,0,Matches,64b08de7
310,John McGinn,sct SCO,MF,Aston Villa,25,1994,37.0,61,37,23,31,7,27,84,32.1,57,38,6,32,43,104,23,2,Matches,90f91999
311,David McGoldrick,ie IRL,FWMF,Sheffield Utd,32,1987,26.6,33,21,8,15,10,13,31,41.9,18,19,3,16,2,35,25,0,Matches,dbe56a33
312,Dwight McNeil,eng ENG,MF,Burnley,20,1999,34.1,47,24,24,18,5,18,56,32.1,38,44,6,38,32,79,32,1,Matches,fc15fb84
313,Scott McTominay,sct SCO,MF,Manchester Utd,23,1996,23.7,51,24,23,25,3,23,36,63.9,13,35,10,25,29,80,46,0,Matches,d93c2511
314,Ben Mee,eng ENG,DF,Burnley,30,1989,29.9,32,15,16,14,2,14,29,48.3,15,54,45,9,43,75,148,2,Matches,8df7a2fb
315,Hannibal Mejbri,tn TUN,MF,Manchester Utd,17,2003,0.1,0,0,0,0,0,0,0,,0,0,0,0,0,0,0,0,Matches,ca22ccb0
316,Benjamin Mendy,fr FRA,DF,Manchester City,26,1994,10.6,13,9,1,8,4,5,21,23.8,16,12,5,7,5,18,14,1,Matches,5271c8f1
317,Edouard Mendy,sn SEN,GK,Chelsea,28,1992,30.5,0,0,0,0,0,0,1,0.0,1,0,0,0,1,1,9,3,Matches,33887998
318,Nampalys Mendy,sn SEN,MF,Leicester City,28,1992,16.2,26,17,18,6,2,7,20,35.0,13,12,1,11,14,40,8,0,Matches,1598599e
319,Illan Meslier,fr FRA,GK,Leeds United,20,2000,35.0,0,0,0,0,0,0,1,0.0,1,0,0,0,0,0,17,8,Matches,6b625ac2
320,Luka Milivojević,rs SRB,MF,Crystal Palace,29,1991,26.2,65,34,25,31,9,42,77,54.5,35,29,6,23,35,100,47,2,Matches,2ce2508a
321,James Milner,eng ENG,MFDF,Liverpool,34,1986,11.9,26,19,9,14,3,11,33,33.3,22,30,3,27,14,40,16,1,Matches,2f90f6b8
322,Yerry Mina,co COL,DF,Everton,25,1994,21.5,21,14,17,4,0,8,12,66.7,4,30,23,7,24,45,110,1,Matches,6d5701f2
323,Takumi Minamino,jp JPN,MF,Southampton,25,1995,7.9,7,3,2,5,0,2,19,10.5,17,13,1,12,4,11,9,0,Matches,f833a830
324,Takumi Minamino,jp JPN,MFFW,Liverpool,25,1995,3.3,4,3,1,2,1,0,12,0.0,12,1,0,1,2,6,3,0,Matches,f833a830
325,Tyrone Mings,eng ENG,DF,Aston Villa,27,1993,35.5,32,16,23,7,2,16,24,66.7,8,59,40,19,41,73,172,3,Matches,8397a50c
326,Tyrick Mitchell,eng ENG,DF,Crystal Palace,20,1999,19.0,64,35,48,9,7,23,40,57.5,17,29,10,19,21,85,62,1,Matches,5cbd1eb0
327,Aleksandar Mitrović,rs SRB,FW,Fulham,25,1994,15.6,7,4,0,3,4,2,8,25.0,6,12,3,9,3,10,8,0,Matches,3925dbd6
328,Jakub Moder,pl POL,DFMF,Brighton,21,1999,7.2,15,7,5,7,3,7,20,35.0,13,12,1,11,3,18,9,0,Matches,f230bc30
329,Jayson Molumby,ie IRL,MF,Brighton,20,1999,0.0,0,0,0,0,0,0,0,,0,0,0,0,0,0,0,0,Matches,c908a1bc
330,Wesley Moraes,br BRA,FW,Aston Villa,23,1996,0.2,0,0,0,0,0,0,1,0.0,1,0,0,0,0,0,0,0,Matches,bfae110f
331,Wes Morgan,jm JAM,DF,Leicester City,36,1984,0.2,0,0,0,0,0,0,0,,0,0,0,0,0,0,1,0,Matches,80c31c97
332,Mason Mount,eng ENG,MF,Chelsea,21,1999,32.1,75,35,22,38,15,25,69,36.2,44,40,2,38,31,106,14,0,Matches,9674002f
333,Lucas Moura,br BRA,FWMF,Tottenham,27,1992,15.7,32,16,12,16,4,8,29,27.6,21,12,0,12,18,50,10,0,Matches,2b622f01
334,Lys Mousset,fr FRA,FWMF,Sheffield Utd,24,1996,3.3,1,0,0,0,1,0,2,0.0,2,1,0,1,0,1,1,1,Matches,d9cfca3d
335,João Moutinho,pt POR,MF,Wolves,33,1986,28.1,75,40,34,35,6,35,91,38.5,56,18,3,15,47,122,28,0,Matches,f5a00fa4
336,Joel Mumbongo,se SWE,FW,Burnley,21,1999,0.4,0,0,0,0,0,0,0,,0,1,0,1,0,0,0,0,Matches,f8e588df
337,Jacob Murphy,eng ENG,DFMF,Newcastle Utd,25,1995,18.1,39,24,25,12,2,24,49,49.0,25,27,3,24,14,53,29,0,Matches,de112b84
338,Shkodran Mustafi,de GER,DF,Arsenal,28,1992,0.5,1,1,1,0,0,1,1,100.0,0,1,0,1,0,1,3,0,Matches,3f2d59fe
339,Marvelous Nakamba,zw ZIM,MF,Aston Villa,26,1994,8.3,22,14,10,11,1,7,12,58.3,5,16,5,11,17,39,9,1,Matches,de5b5570
340,Iliman Ndiaye,sn SEN,MF,Sheffield Utd,20,2000,0.1,1,1,0,1,0,1,1,100.0,0,0,0,0,0,1,0,0,Matches,5ed97752
341,Wilfred Ndidi,ng NGA,MFDF,Leicester City,23,1996,24.2,96,63,45,44,7,26,66,39.4,40,38,11,27,61,157,55,0,Matches,6b47c5db
342,Tanguy Ndombele,fr FRA,MF,Tottenham,23,1996,23.2,41,20,11,21,9,18,44,40.9,26,28,4,24,19,60,15,0,Matches,5cdddffa
343,Reiss Nelson,eng ENG,FWMF,Arsenal,20,1999,0.8,1,0,0,0,1,0,0,,0,0,0,0,1,2,1,0,Matches,c5bdb6e3
344,Pedro Neto,pt POR,FWMF,Wolves,20,2000,28.3,16,9,4,6,6,6,28,21.4,22,18,2,16,31,47,8,0,Matches,7ba2eaa9
345,Rúben Neves,pt POR,MF,Wolves,23,1997,29.7,86,46,42,38,6,36,88,40.9,52,55,11,44,65,151,46,2,Matches,44bfb6c5
346,Eddie Nketiah,eng ENG,FW,Arsenal,21,1999,4.7,3,1,0,2,1,0,2,0.0,2,6,0,6,0,3,5,0,Matches,a53649b7
347,Niels Nkounkou,fr FRA,DFFW,Everton,19,2000,0.9,4,3,1,2,1,3,8,37.5,5,4,0,4,0,4,4,0,Matches,f5b281e7
348,Dan Nlundulu,eng ENG,FWMF,Southampton,21,1999,1.2,0,0,0,0,0,0,1,0.0,1,2,0,2,0,0,2,0,Matches,30040f5d
349,Mark Noble,eng ENG,MF,West Ham,33,1987,7.9,8,4,2,5,1,4,14,28.6,10,7,3,4,13,21,3,0,Matches,ff527768
350,Will Norris,eng ENG,GK,Burnley,26,1993,2.0,0,0,0,0,0,0,0,,0,0,0,0,0,0,0,0,Matches,c73ada83
351,Oliver Norwood,nir NIR,MF,Sheffield Utd,29,1991,24.7,49,22,16,28,5,21,72,29.2,51,29,12,17,36,85,51,1,Matches,43439614
352,Jack O'Connell,eng ENG,DF,Sheffield Utd,26,1994,2.0,3,1,1,1,1,0,1,0.0,1,4,3,1,2,5,7,0,Matches,312626c1
353,Dara O'Shea,ie IRL,DF,West Brom,21,1999,23.4,45,25,30,13,2,21,45,46.7,24,32,17,15,45,90,108,0,Matches,1d042188
354,Michael Obafemi,ie IRL,FW,Southampton,20,2000,0.7,1,0,0,1,0,0,1,0.0,1,1,0,1,0,1,0,0,Matches,caa1a7f0
355,Denis Odoi,gh GHA,DF,Fulham,32,1988,3.0,3,3,2,1,0,1,4,25.0,3,3,1,2,5,8,5,0,Matches,f7750aa0
356,Angelo Ogbonna,it ITA,DF,West Ham,32,1988,27.7,26,13,20,5,1,9,17,52.9,8,25,11,14,30,56,119,0,Matches,74b2cd7e
357,Robin Olsen,se SWE,GK,Everton,30,1990,7.0,0,0,0,0,0,0,0,,0,0,0,0,0,0,4,1,Matches,e7ee38c3
358,Josh Onomah,eng ENG,MF,Fulham,23,1997,4.2,11,8,1,6,4,0,5,0.0,5,4,2,2,2,13,1,0,Matches,6612cd8c
359,Divock Origi,be BEL,FW,Liverpool,25,1995,2.1,3,2,0,2,1,1,3,33.3,2,5,1,4,1,4,2,0,Matches,43a166b4
360,Ben Osborn,eng ENG,MFDF,Sheffield Utd,25,1994,17.8,33,18,15,10,8,13,40,32.5,27,20,3,17,12,45,17,0,Matches,79bc4c45
361,Owen Otasowie,us USA,MFFW,Wolves,19,2001,2.1,5,5,3,2,0,1,2,50.0,1,1,1,0,3,8,4,0,Matches,6956ff08
362,Alex Oxlade-Chamberlain,eng ENG,MFFW,Liverpool,26,1993,2.8,4,0,0,3,1,0,2,0.0,2,1,0,1,2,6,0,0,Matches,38c7feef
363,Emerson Palmieri,it ITA,DF,Chelsea,25,1994,1.0,3,3,2,0,1,1,3,33.3,2,0,0,0,1,4,6,0,Matches,e0bc6fdc
364,Thomas Partey,gh GHA,MF,Arsenal,27,1993,17.0,44,21,16,24,4,24,56,42.9,32,17,5,12,23,67,18,0,Matches,529f49ab
365,Rui Patrício,pt POR,GK,Wolves,32,1988,37.0,0,0,0,0,0,0,1,0.0,1,0,0,0,1,1,3,3,Matches,79b0d6a0
366,Bailey Peacock-Farrell,nir NIR,GK,Burnley,23,1996,4.0,0,0,0,0,0,0,0,,0,0,0,0,0,0,0,0,Matches,4879f8cb
367,Lee Peltier,eng ENG,DF,West Brom,33,1986,2.5,9,4,8,1,0,4,4,100.0,0,1,1,0,1,10,11,0,Matches,af341b88
368,Nicolas Pépé,ci CIV,FW,Arsenal,25,1995,18.0,20,15,8,6,6,8,23,34.8,15,16,1,15,12,32,19,0,Matches,57e3f0c7
369,Matheus Pereira,pt POR,MFFW,West Brom,24,1996,28.6,26,15,14,10,2,12,54,22.2,42,18,0,18,29,55,16,0,Matches,b04ee927
370,Ricardo Pereira,pt POR,DFFW,Leicester City,26,1993,10.7,31,22,16,8,7,14,35,40.0,21,24,1,23,15,46,23,0,Matches,75a72a99
371,Ayoze Pérez,es ESP,MFFW,Leicester City,27,1993,14.8,32,15,6,20,6,13,48,27.1,35,28,0,28,10,42,7,0,Matches,819aa8e7
372,Kalvin Phillips,eng ENG,MF,Leeds United,24,1995,27.0,74,38,38,29,7,26,62,41.9,36,49,14,35,45,119,53,3,Matches,4f565d77
373,Matt Phillips,sct SCO,MF,West Brom,29,1991,20.3,15,8,4,11,0,7,23,30.4,16,32,4,28,10,25,32,1,Matches,7bb5f40e
374,Nathaniel Phillips,eng ENG,DF,Liverpool,23,1997,16.2,22,14,15,7,0,11,24,45.8,13,17,14,3,20,42,81,0,Matches,515ebe8d
375,Jaden Philogene Bidace,eng ENG,FW,Aston Villa,18,2002,0.0,0,0,0,0,0,0,0,,0,0,0,0,0,0,0,0,Matches,19f4d211
376,Jordan Pickford,eng ENG,GK,Everton,26,1994,30.5,0,0,0,0,0,0,2,0.0,2,2,0,2,3,3,16,4,Matches,4806ec67
377,Erik Pieters,nl NED,DFMF,Burnley,31,1988,14.1,30,21,18,9,3,19,39,48.7,20,30,9,21,12,42,34,0,Matches,1ef37668
378,Daniel Podence,pt POR,MFFW,Wolves,24,1995,18.5,12,6,5,5,2,2,19,10.5,17,5,1,4,13,25,2,0,Matches,7fcc71d8
379,Paul Pogba,fr FRA,MFFW,Manchester Utd,27,1993,21.1,36,26,15,16,5,11,33,33.3,22,24,2,22,26,62,37,0,Matches,867239d3
380,Nick Pope,eng ENG,GK,Burnley,28,1992,32.0,1,1,1,0,0,0,1,0.0,1,0,0,0,2,3,29,2,Matches,4b40d9ca
381,Dennis Praet,be BEL,MF,Leicester City,26,1994,8.0,14,7,4,7,3,6,15,40.0,9,12,2,10,7,21,3,0,Matches,86695068
382,Davy Pröpper,nl NED,MF,Brighton,28,1991,2.4,6,5,0,6,0,2,5,40.0,3,3,0,3,1,7,0,0,Matches,fdd85f94
383,Christian Pulisic,us USA,FWMF,Chelsea,21,1998,19.3,19,11,8,10,1,8,21,38.1,13,25,2,23,12,31,9,0,Matches,1bf33a9a
384,Aaron Ramsdale,eng ENG,GK,Sheffield Utd,22,1998,38.0,1,1,1,0,0,1,1,100.0,0,0,0,0,2,3,22,6,Matches,466fb2c5
385,Jacob Ramsey,eng ENG,MF,Aston Villa,19,2001,7.0,10,5,3,4,3,2,12,16.7,10,13,6,7,4,14,5,0,Matches,1544f145
386,Kayne Ramsey,eng ENG,DF,Southampton,19,2000,1.0,5,2,4,1,0,3,3,100.0,0,0,0,0,0,5,3,0,Matches,dc31b84c
387,Darren Randolph,ie IRL,GK,West Ham,33,1987,3.0,0,0,0,0,0,0,0,,0,0,0,0,0,0,1,0,Matches,6385ebfb
388,Raphinha,br BRA,MFFW,Leeds United,23,1996,26.2,34,17,13,16,5,12,58,20.7,46,31,1,30,29,63,27,0,Matches,3423f250
389,Marcus Rashford,eng ENG,FW,Manchester Utd,22,1997,32.4,18,9,2,8,8,7,27,25.9,20,22,2,20,8,26,10,0,Matches,a1d5bd30
390,Tim Ream,us USA,DF,Fulham,32,1987,7.0,12,5,9,3,0,8,11,72.7,3,8,5,3,6,18,26,1,Matches,28b40c9c
391,Nathan Redmond,eng ENG,MFFW,Southampton,26,1994,19.3,30,17,14,12,4,8,24,33.3,16,24,2,22,11,41,9,0,Matches,ab651565
392,Harrison Reed,eng ENG,MF,Fulham,25,1995,25.0,63,38,28,28,7,29,73,39.7,44,34,11,23,50,113,31,1,Matches,803ae100
393,Sergio Reguilón,es ESP,DF,Tottenham,23,1996,24.9,47,25,30,13,4,23,48,47.9,25,39,7,32,32,79,50,1,Matches,3353737a
394,Bobby Reid,jm JAM,MFFW,Fulham,27,1993,26.4,31,15,17,10,4,18,39,46.2,21,19,5,14,21,52,39,0,Matches,0f7533cd
395,Declan Rice,eng ENG,MF,West Ham,21,1999,32.0,59,35,33,25,1,21,51,41.2,30,39,11,28,59,118,41,0,Matches,1c7012b8
396,Lewis Richardson,eng ENG,FWMF,Burnley,17,2003,0.0,0,0,0,0,0,0,0,,0,0,0,0,0,0,0,0,Matches,4fa62ae4
397,Richarlison,br BRA,FW,Everton,23,1997,31.8,50,32,21,22,7,16,51,31.4,35,28,3,25,14,64,36,1,Matches,fa031b34
398,Jaïro Riedewald,nl NED,MF,Crystal Palace,23,1996,20.2,34,15,13,17,4,16,36,44.4,20,39,7,32,29,63,25,0,Matches,7a1f2c08
399,Matt Ritchie,sct SCO,DFMF,Newcastle Utd,30,1989,15.0,10,3,5,3,2,3,17,17.6,14,17,2,15,12,22,47,0,Matches,71ef519e
400,Tyler Roberts,wls WAL,MFFW,Leeds United,21,1999,14.9,15,13,1,11,3,5,22,22.7,17,17,2,15,9,24,12,0,Matches,6c17e046
401,Andrew Robertson,sct SCO,DF,Liverpool,26,1994,37.6,46,34,23,18,5,28,57,49.1,29,39,9,30,21,67,79,1,Matches,2e4f5f03
402,Antonee Robinson,us USA,DF,Fulham,22,1997,24.0,45,28,24,16,5,27,44,61.4,17,21,4,17,37,82,68,0,Matches,289601e6
403,Callum Robinson,ie IRL,FWMF,West Brom,25,1995,17.3,7,5,5,1,1,3,19,15.8,16,9,0,9,7,14,8,0,Matches,e75750a3
404,Jack Robinson,eng ENG,DF,Sheffield Utd,26,1993,9.7,14,6,8,5,1,6,11,54.5,5,10,4,6,9,23,42,0,Matches,7399c7a8
405,Hal Robson-Kanu,wls WAL,FW,West Brom,31,1989,6.2,2,1,1,0,1,0,1,0.0,1,2,0,2,2,4,7,0,Matches,fb2dec57
406,Marek Rodák,sk SVK,GK,Fulham,23,1996,2.0,0,0,0,0,0,0,0,,0,0,0,0,0,0,0,0,Matches,17acc2ed
407,Joe Rodon,wls WAL,DF,Tottenham,22,1997,8.1,14,9,11,2,1,3,4,75.0,1,10,8,2,21,35,36,2,Matches,8d62d31a
408,Rodri,es ESP,MF,Manchester City,24,1996,30.5,72,40,24,40,8,33,66,50.0,33,23,9,14,36,108,54,3,Matches,6434f10d
409,Rodrigo,es ESP,MFFW,Leeds United,29,1991,14.3,14,7,8,3,3,4,22,18.2,18,7,0,7,5,19,16,0,Matches,1fb1c435
410,James Rodríguez,co COL,FWMF,Everton,29,1991,19.6,28,17,8,15,5,11,46,23.9,35,17,0,17,15,43,3,0,Matches,715bf047
411,Jay Rodriguez,eng ENG,FW,Burnley,31,1989,14.1,25,16,5,15,5,13,28,46.4,15,25,4,21,2,27,7,0,Matches,4ab53cdb
412,Oriol Romeu,es ESP,MF,Southampton,28,1991,19.6,69,35,25,39,5,26,68,38.2,42,28,7,21,30,99,18,0,Matches,4b511457
413,John Ruddy,eng ENG,GK,Wolves,33,1986,1.0,0,0,0,0,0,0,0,,0,0,0,0,0,0,0,0,Matches,da8b19e2
414,Antonio Rüdiger,de GER,DF,Chelsea,27,1993,19.0,31,23,16,14,1,12,15,80.0,3,17,10,7,18,49,51,0,Matches,18b896d6
415,Mathew Ryan,au AUS,GK,Arsenal,28,1992,3.0,0,0,0,0,0,0,0,,0,0,0,0,0,0,1,0,Matches,4535e4bb
416,Mathew Ryan,au AUS,GK,Brighton,28,1992,11.0,1,0,1,0,0,0,0,,0,0,0,0,0,1,4,0,Matches,4535e4bb
417,Allan Saint-Maximin,fr FRA,FWMF,Newcastle Utd,23,1997,17.3,16,9,6,9,1,4,9,44.4,5,10,0,10,4,20,2,0,Matches,2b16cb1a
418,Romain Saïss,ma MAR,DF,Wolves,30,1990,26.7,35,24,23,12,0,19,33,57.6,14,28,13,15,52,87,115,1,Matches,9fbbcf39
419,Bukayo Saka,eng ENG,FWMF,Arsenal,18,2001,28.4,25,16,10,13,2,11,40,27.5,29,21,2,19,25,50,24,0,Matches,bc7dc64d
420,Mamadou Sakho,fr FRA,DF,Crystal Palace,30,1990,3.1,3,2,1,2,0,3,3,100.0,0,3,2,1,3,6,11,0,Matches,87935cf3
421,Mohamed Salah,eg EGY,FW,Liverpool,28,1992,34.2,18,9,4,4,10,7,16,43.8,9,10,0,10,1,19,10,1,Matches,e342ad68
422,Mohammed Salisu,gh GHA,DF,Southampton,21,1999,9.4,38,21,20,16,2,25,34,73.5,9,22,5,17,17,55,30,0,Matches,0b33f6ad
423,Davinson Sánchez,co COL,DF,Tottenham,24,1996,16.5,40,20,31,9,0,21,32,65.6,11,18,13,5,14,54,85,2,Matches,da7b447d
424,Robert Sánchez,es ESP,GK,Brighton,22,1997,27.0,1,0,1,0,0,1,1,100.0,0,1,0,1,1,2,11,2,Matches,6a713852
425,Morgan Sanson,fr FRA,MF,Aston Villa,25,1994,3.3,7,4,4,2,1,1,4,25.0,3,5,0,5,4,11,1,0,Matches,6e7f1353
426,Romaine Sawyers,kn SKN,MF,West Brom,28,1991,16.5,30,18,16,12,2,14,43,32.6,29,20,4,16,18,48,12,3,Matches,77bb1522
427,Dane Scarlett,eng ENG,FW,Tottenham,16,2004,0.0,0,0,0,0,0,0,0,,0,0,0,0,0,0,0,0,Matches,21945a9e
428,Fabian Schär,ch SUI,DF,Newcastle Utd,28,1991,13.8,13,4,8,5,0,7,19,36.8,12,19,12,7,27,40,52,1,Matches,c8aa95da
429,Jeffrey Schlupp,gh GHA,MF,Crystal Palace,27,1992,15.9,29,16,14,12,3,6,23,26.1,17,24,8,16,22,51,16,0,Matches,3312f911
430,Kasper Schmeichel,dk DEN,GK,Leicester City,33,1986,38.0,0,0,0,0,0,0,0,,0,0,0,0,0,0,10,0,Matches,53af52f3
431,Nélson Semedo,pt POR,DFMF,Wolves,26,1993,33.1,85,48,53,23,9,42,72,58.3,30,30,10,20,41,126,78,2,Matches,d04b94db
432,Femi Seriki,eng ENG,MF,Sheffield Utd,18,2002,0.0,0,0,0,0,0,0,0,,0,0,0,0,0,0,0,0,Matches,e4e0deaa
433,Jamie Shackleton,eng ENG,MFDF,Leeds United,20,1999,5.1,10,6,6,4,0,4,11,36.4,7,3,1,2,9,19,3,0,Matches,8d03ca5a
434,Xherdan Shaqiri,ch SUI,MFFW,Liverpool,28,1991,6.2,7,4,3,1,3,2,7,28.6,5,4,0,4,2,9,0,0,Matches,6421ec64
435,Billy Sharp,eng ENG,FW,Sheffield Utd,34,1986,8.2,5,1,0,3,2,2,9,22.2,7,2,0,2,0,5,2,0,Matches,e8c9f4e9
436,Luke Shaw,eng ENG,DF,Manchester Utd,25,1995,29.5,44,28,21,16,7,21,36,58.3,15,34,9,25,20,64,44,2,Matches,9c94165b
437,Jonjo Shelvey,eng ENG,MF,Newcastle Utd,28,1992,29.1,39,14,18,19,2,10,37,27.0,27,26,14,12,36,75,42,0,Matches,3727dd3c
438,Shola Shoretire,eng ENG,FW,Manchester Utd,16,2004,0.1,0,0,0,0,0,0,0,,0,0,0,0,0,0,0,0,Matches,00f0482f
439,Gylfi Sigurðsson,is ISL,MFFW,Everton,30,1989,25.0,30,20,9,14,7,13,44,29.5,31,31,2,29,34,64,21,1,Matches,76dd1480
440,Bernardo Silva,pt POR,MFFW,Manchester City,25,1994,22.9,26,14,7,12,7,11,52,21.2,41,17,1,16,17,43,8,0,Matches,3eb22ec9
441,Fábio Silva,pt POR,FW,Wolves,18,2002,15.2,6,4,1,4,1,4,12,33.3,8,12,1,11,4,10,5,1,Matches,e7aa9d7c
442,Thiago Silva,br BRA,DF,Chelsea,35,1984,21.5,20,12,11,8,1,14,21,66.7,7,21,13,8,33,53,86,1,Matches,86e7deaf
443,Moussa Sissoko,fr FRA,MF,Tottenham,30,1989,17.6,22,16,19,3,0,8,20,40.0,12,11,4,7,23,45,25,0,Matches,2acd49b9
444,Islam Slimani,dz ALG,FW,Leicester City,32,1988,0.2,0,0,0,0,0,0,0,,0,0,0,0,0,0,0,0,Matches,ffec9769
445,William Smallbone,ie IRL,MF,Southampton,20,2000,1.9,6,3,2,4,0,1,3,33.3,2,5,0,5,2,8,1,0,Matches,5e105217
446,Emile Smith Rowe,eng ENG,MFFW,Arsenal,20,2000,16.0,14,7,5,5,4,6,17,35.3,11,15,1,14,10,24,12,0,Matches,17695062
447,Robert Snodgrass,sct SCO,MFFW,West Brom,32,1987,5.8,17,12,12,4,1,10,16,62.5,6,11,2,9,1,18,12,0,Matches,9f4647e9
448,Robert Snodgrass,sct SCO,FWMF,West Ham,32,1987,0.1,0,0,0,0,0,0,0,,0,0,0,0,0,0,0,0,Matches,9f4647e9
449,Cédric Soares,pt POR,DF,Arsenal,28,1991,8.3,12,8,6,4,2,6,21,28.6,15,6,1,5,8,20,16,1,Matches,839c14e1
450,Tomáš Souček,cz CZE,MF,West Ham,25,1995,38.0,78,41,37,36,5,28,77,36.4,49,43,18,25,62,140,107,0,Matches,6613c819
451,Çağlar Söyüncü,tr TUR,DF,Leicester City,24,1996,20.2,27,17,13,14,0,17,30,56.7,13,12,9,3,28,55,80,1,Matches,21166ff4
452,Zack Steffen,us USA,GK,Manchester City,25,1995,1.0,0,0,0,0,0,0,0,,0,0,0,0,0,0,0,0,Matches,42130443
453,Dale Stephens,eng ENG,MF,Burnley,31,1989,2.9,11,6,2,7,2,3,6,50.0,3,3,0,3,8,19,2,0,Matches,653ee42d
454,Jack Stephens,eng ENG,DF,Southampton,26,1994,17.1,34,19,19,15,0,17,38,44.7,21,25,14,11,28,62,64,2,Matches,6adbc307
455,Raheem Sterling,eng ENG,FW,Manchester City,25,1994,28.2,21,10,5,12,4,5,12,41.7,7,15,0,15,15,36,4,0,Matches,b400bde0
456,Enda Stevens,ie IRL,DF,Sheffield Utd,30,1990,30.0,59,26,32,19,8,33,58,56.9,25,41,12,29,22,81,81,1,Matches,17d4507a
457,John Stones,eng ENG,DF,Manchester City,26,1994,21.5,21,10,13,5,3,9,14,64.3,5,23,15,8,18,39,56,1,Matches,5eecec3d
458,Pascal Struijk,nl NED,DFMF,Leeds United,20,1999,23.1,49,30,28,19,2,17,28,60.7,11,35,21,14,47,96,92,0,Matches,f4d296e4
459,Japhet Tanganga,eng ENG,DF,Tottenham,21,1999,5.4,5,4,3,2,0,1,3,33.3,2,6,5,1,3,8,15,0,Matches,e9971f2d
460,Matt Targett,eng ENG,DF,Aston Villa,24,1995,37.8,83,39,52,20,11,56,88,63.6,32,40,14,26,55,138,102,1,Matches,e514ab62
461,James Tarkowski,eng ENG,DF,Burnley,27,1992,36.0,66,39,52,11,3,25,49,51.0,24,54,42,12,44,110,163,1,Matches,15ea812b
462,Percy Tau,za RSA,FW,Brighton,26,1994,1.1,1,1,1,0,0,0,2,0.0,2,1,0,1,0,1,1,0,Matches,4d0eb7d2
463,Sidnei Tavares,pt POR,MF,Leicester City,18,2001,0.9,1,1,0,1,0,0,0,,0,1,1,0,0,1,0,0,Matches,3add8ed8
464,Charlie Taylor,eng ENG,DF,Burnley,26,1993,27.0,48,28,30,15,3,25,46,54.3,21,36,19,17,29,77,87,2,Matches,cc2d7ad5
465,Neil Taylor,wls WAL,DF,Aston Villa,31,1989,0.2,1,1,1,0,0,0,0,,0,1,0,1,0,1,0,0,Matches,c2f9d19f
466,Allan Tchaptchet,fr FRA,DF,Southampton,18,2001,0.1,0,0,0,0,0,0,0,,0,0,0,0,0,0,0,0,Matches,ab7d7882
467,Nathan Tella,eng ENG,FWMF,Southampton,21,1999,8.3,8,5,1,4,3,6,15,40.0,9,13,0,13,3,11,2,0,Matches,f1e94cd6
468,Alex Telles,br BRA,DF,Manchester Utd,27,1992,7.7,14,7,10,3,1,8,17,47.1,9,7,2,5,16,30,20,0,Matches,e73c9bb2
469,Kenny Tete,nl NED,DFMF,Fulham,24,1995,16.5,48,30,27,16,5,10,18,55.6,8,14,5,9,27,75,49,0,Matches,77d7c96f
470,William Thomas Fish,eng ENG,FW,Manchester Utd,17,2003,0.0,0,0,0,0,0,0,0,,0,0,0,0,0,0,0,0,Matches,b2ee9d2c
471,Luke Thomas,eng ENG,DF,Leicester City,19,2001,10.8,23,14,11,5,7,14,21,66.7,7,15,2,13,17,40,21,0,Matches,fc027d02
472,Youri Tielemans,be BEL,MF,Leicester City,23,1997,37.3,86,45,32,38,16,45,108,41.7,63,35,8,27,46,132,20,1,Matches,56f7a928
473,Kieran Tierney,sct SCO,DF,Arsenal,23,1997,25.5,27,15,5,14,8,11,31,35.5,20,31,10,21,16,43,63,0,Matches,fce2302c
474,James Tomkins,eng ENG,DF,Crystal Palace,31,1989,6.1,4,2,4,0,0,3,4,75.0,1,4,3,1,4,8,45,0,Matches,e7ca0439
475,Fikayo Tomori,eng ENG,DF,Chelsea,22,1997,0.5,2,1,2,0,0,0,0,,0,1,1,0,2,4,8,0,Matches,7edfbb8a
476,Ferrán Torres,es ESP,FWMF,Manchester City,20,2000,14.5,12,5,4,6,2,5,16,31.3,11,16,0,16,3,15,8,0,Matches,9e1035f8
477,Cenk Tosun,tr TUR,FW,Everton,29,1991,0.5,0,0,0,0,0,0,1,0.0,1,0,0,0,0,0,0,0,Matches,9a104dee
478,Andros Townsend,eng ENG,MFFW,Crystal Palace,29,1991,25.1,78,41,45,20,13,30,79,38.0,49,48,2,46,41,119,19,0,Matches,b28bbd58
479,Conor Townsend,eng ENG,DF,West Brom,27,1993,24.8,44,28,32,9,3,30,49,61.2,19,38,15,23,36,80,55,2,Matches,4dc4f138
480,Adama Traoré,es ESP,FWMF,Wolves,24,1996,29.4,28,16,11,13,4,13,21,61.9,8,23,1,22,7,35,12,1,Matches,9a28eba4
481,Bertrand Traoré,bf BFA,FW,Aston Villa,24,1995,25.7,26,10,8,10,8,10,34,29.4,24,23,1,22,15,41,14,1,Matches,c47541e0
482,Trézéguet,eg EGY,FW,Aston Villa,25,1994,13.0,33,18,14,15,4,13,45,28.9,32,13,1,12,19,52,17,0,Matches,3ae14ed1
483,Leandro Trossard,be BEL,MFFW,Brighton,25,1994,29.0,33,14,11,16,6,10,36,27.8,26,34,2,32,26,59,7,1,Matches,38ceb24a
484,Kostas Tsimikas,gr GRE,DFFW,Liverpool,24,1996,0.1,0,0,0,0,0,0,0,,0,0,0,0,0,0,0,0,Matches,f315ca93
485,Axel Tuanzebe,eng ENG,DF,Manchester Utd,22,1997,4.5,13,7,5,7,1,8,9,88.9,1,7,5,2,3,16,18,0,Matches,2baec6ce
486,Cengiz Ünder,tr TUR,FWMF,Leicester City,23,1997,3.1,4,1,0,3,1,3,5,60.0,2,3,0,3,2,6,0,0,Matches,1880614f
487,Yan Valery,tn TUN,DFMF,Southampton,21,1999,1.1,5,3,2,3,0,1,5,20.0,4,2,0,2,2,7,5,0,Matches,531a4aa8
488,Virgil van Dijk,nl NED,DF,Liverpool,29,1991,4.1,3,2,1,2,0,0,0,,0,1,1,0,5,8,8,1,Matches,e06683ca
489,Jamie Vardy,eng ENG,FW,Leicester City,33,1987,31.6,18,12,1,8,9,2,15,13.3,13,14,5,9,4,22,32,0,Matches,45963054
490,Joël Veltman,nl NED,DF,Brighton,28,1992,25.3,67,33,34,25,8,29,57,50.9,28,24,5,19,33,100,64,0,Matches,dad4b285
491,Jannik Vestergaard,dk DEN,DF,Southampton,27,1992,28.6,50,31,31,15,4,35,52,67.3,17,29,16,13,42,92,122,0,Matches,1900032e
492,Rúben Vinagre,pt POR,MFDF,Wolves,21,1999,1.9,7,5,5,2,0,3,4,75.0,1,3,0,3,2,9,4,0,Matches,b937e490
493,Carlos Vinícius,br BRA,FW,Tottenham,25,1995,3.4,3,1,2,1,0,1,1,100.0,0,0,0,0,2,5,5,0,Matches,8b529245
494,João Virgínia,pt POR,GK,Everton,20,1999,0.5,0,0,0,0,0,0,0,,0,0,0,0,0,0,0,0,Matches,728e9b2e
495,Vitinha,pt POR,MF,Wolves,20,2000,5.8,7,3,2,5,0,3,8,37.5,5,3,0,3,3,10,1,0,Matches,3b029691
496,Jake Vokins,eng ENG,DF,Southampton,20,2000,0.7,0,0,0,0,0,0,1,0.0,1,0,0,0,0,0,0,0,Matches,d484c261
497,Matěj Vydra,cz CZE,FW,Burnley,28,1992,15.2,9,5,2,4,3,1,8,12.5,7,8,1,7,6,15,5,0,Matches,0d4ceb32
498,Theo Walcott,eng ENG,MFFW,Southampton,31,1989,18.0,23,11,8,9,6,11,32,34.4,21,16,0,16,14,37,5,0,Matches,1ecb65be
499,Theo Walcott,eng ENG,FW,Everton,31,1989,0.1,0,0,0,0,0,0,0,,0,0,0,0,0,0,0,0,Matches,1ecb65be
500,Kyle Walker,eng ENG,DF,Manchester City,30,1990,21.6,29,19,15,12,2,16,24,66.7,8,19,7,12,14,43,28,0,Matches,86dd77d1
501,Kyle Walker-Peters,eng ENG,DF,Southampton,23,1997,29.4,83,53,56,25,2,34,57,59.6,23,41,10,31,38,121,66,2,Matches,984a5a64
502,Aaron Wan-Bissaka,eng ENG,DF,Manchester Utd,22,1997,34.0,88,54,53,29,6,32,45,71.1,13,65,17,48,62,150,84,2,Matches,9e525177
503,Joel Ward,eng ENG,DF,Crystal Palace,30,1989,25.1,43,25,29,14,0,24,42,57.1,18,27,8,19,41,84,87,2,Matches,8a7ff278
504,James Ward-Prowse,eng ENG,MF,Southampton,25,1994,38.0,75,49,30,41,4,29,70,41.4,41,36,4,32,42,117,60,0,Matches,3515d404
505,Ollie Watkins,eng ENG,FW,Aston Villa,24,1995,37.0,29,17,5,16,8,10,33,30.3,23,21,2,19,7,36,24,0,Matches,aed3a70f
506,Caleb Watts,au AUS,MF,Southampton,18,2002,0.4,2,1,2,0,0,1,2,50.0,1,0,0,0,0,2,0,0,Matches,c7170b46
507,Adam Webster,eng ENG,DF,Brighton,25,1995,28.8,29,16,15,10,4,12,25,48.0,13,29,16,13,47,76,92,3,Matches,c40b6180
508,Danny Welbeck,eng ENG,FW,Brighton,29,1990,17.2,12,6,2,6,4,7,19,36.8,12,17,0,17,7,19,13,0,Matches,ce5143da
509,Timo Werner,de GER,FWMF,Chelsea,24,1996,28.9,20,9,6,11,3,7,43,16.3,36,23,1,22,8,28,8,0,Matches,49fe9070
510,Ashley Westwood,eng ENG,MF,Burnley,30,1990,37.9,23,15,6,12,5,10,42,23.8,32,26,9,17,44,67,33,0,Matches,495945ef
511,Ben White,eng ENG,DFMF,Brighton,22,1997,35.5,49,26,21,24,4,24,57,42.1,33,46,22,24,62,111,56,0,Matches,35e413f1
512,Georginio Wijnaldum,nl NED,MF,Liverpool,29,1990,32.7,23,7,6,14,3,7,31,22.6,24,18,3,15,26,49,18,1,Matches,eb58eef0
513,Brandon Williams,eng ENG,DF,Manchester Utd,19,2000,2.1,0,0,0,0,0,0,1,0.0,1,1,0,1,1,1,7,0,Matches,5e74d6c8
514,Neco Williams,wls WAL,DF,Liverpool,19,2001,2.8,6,5,4,2,0,5,9,55.6,4,3,1,2,6,12,6,0,Matches,dd323728
515,Rhys Williams,eng ENG,DF,Liverpool,19,2001,7.3,6,4,3,3,0,3,3,100.0,0,4,3,1,6,12,27,1,Matches,012c975a
516,Willian,br BRA,FW,Arsenal,31,1988,15.6,13,7,6,6,1,6,16,37.5,10,13,0,13,8,21,8,0,Matches,8b9ebd03
517,Joe Willock,eng ENG,MF,Arsenal,20,1999,2.6,6,3,1,4,1,3,7,42.9,4,6,1,5,3,9,0,0,Matches,a3b03921
518,Joe Willock,eng ENG,MF,Newcastle Utd,20,1999,10.9,26,13,16,7,3,9,42,21.4,33,21,3,18,17,43,15,1,Matches,a3b03921
519,Callum Wilson,eng ENG,FW,Newcastle Utd,28,1992,23.2,12,5,1,6,5,2,12,16.7,10,10,3,7,7,19,14,0,Matches,c596fcb0
520,Harry Winks,eng ENG,MF,Tottenham,24,1996,9.6,16,9,11,5,0,5,20,25.0,15,16,4,12,11,27,12,1,Matches,2f7acede
521,Chris Wood,nz NZL,FW,Burnley,28,1991,30.5,12,7,2,4,6,5,18,27.8,13,14,3,11,1,13,21,0,Matches,4e9a0555
522,Granit Xhaka,ch SUI,MFDF,Arsenal,27,1992,28.0,50,26,18,17,15,30,58,51.7,28,23,7,16,24,74,38,3,Matches,e61b8aee
523,Andriy Yarmolenko,ua UKR,FWMF,West Ham,30,1989,4.2,5,4,2,2,1,2,8,25.0,6,1,0,1,1,6,2,0,Matches,849c826a
524,DeAndre Yedlin,us USA,DF,Newcastle Utd,27,1993,4.8,9,4,8,1,0,4,10,40.0,6,5,1,4,7,16,17,0,Matches,ae0a7ddf
525,Okay Yokuşlu,tr TUR,MF,West Brom,26,1994,14.6,38,25,21,13,4,17,35,48.6,18,15,3,12,35,73,33,1,Matches,e49ce451
526,Wilfried Zaha,ci CIV,FW,Crystal Palace,27,1992,29.0,26,18,8,15,3,11,30,36.7,19,21,0,21,9,35,4,0,Matches,b2bc3b1f
527,Andre-Frank Zambo Anguissa,cm CMR,MF,Fulham,24,1995,28.7,78,37,27,38,13,27,68,39.7,41,35,6,29,56,134,17,2,Matches,6bb2c084
528,Andi Zeqiri,ch SUI,FWDF,Brighton,21,1999,1.9,3,2,0,2,1,1,2,50.0,1,1,0,1,0,3,2,0,Matches,d01231f0
529,Oleksandr Zinchenko,ua UKR,DF,Manchester City,23,1996,16.4,25,15,12,9,4,14,24,58.3,10,17,4,13,23,48,28,0,Matches,51cf8561
530,Hakim Ziyech,ma MAR,MFFW,Chelsea,27,1993,13.0,14,10,5,7,2,5,19,26.3,14,9,1,8,10,24,2,0,Matches,6622454d
531,Kurt Zouma,fr FRA,DF,Chelsea,25,1994,22.5,16,10,8,6,2,4,8,50.0,4,13,9,4,28,44,93,0,Matches,ce4246f5
532,Martin Ødegaard,no NOR,MF,Arsenal,21,1998,9.6,9,3,2,6,1,4,14,28.6,10,2,0,2,2,11,5,0,Matches,79300479